fips_code,total_population,male,female,median_age,white_pop,african_american_pop,american_indian_pop,asian_pop,hawaiian_islander_pop,other_pop,hispanic_pop
1001,54590,26538,28052,37.0,43084,9880,169,439,0,212,54590
1003,183226,89270,93956,41.2,158259,17016,1038,1347,4,2645,183226
1005,27469,14749,12720,38.2,13448,12645,25,212,0,570,27469
1007,22769,12154,10615,39.4,17459,4953,80,25,0,9,22769
1009,57466,28489,28977,39.1,54507,754,230,97,0,1019,57466
1011,10779,5996,4783,40.7,3028,7609,24,0,35,0,10779
1013,20730,9738,10992,40.3,11380,8961,36,183,0,22,20730
1015,117834,56686,61148,38.7,88405,24421,318,827,84,1700,117834
1017,34228,16232,17996,41.4,20171,13409,17,178,16,47,34228
1019,25917,12748,13169,44.3,24074,1253,163,78,5,74,25917
1021,43611,21490,22121,37.6,37872,4314,160,97,0,835,43611
1023,13838,6696,7142,44.0,7670,5935,0,30,0,27,13838
1025,25768,12181,13587,39.9,14015,11310,122,94,0,47,25768
1027,13828,6786,7042,41.7,11332,2157,25,0,0,118,13828
1029,14905,7327,7578,41.2,14122,573,30,0,0,19,14905
1031,49966,24676,25290,37.8,38651,8663,440,654,0,305,49966
1033,54451,26164,28287,41.7,43915,8730,300,233,8,421,54451
1035,13188,6430,6758,43.3,6794,6130,72,12,0,0,13188
1037,11305,5761,5544,44.4,7647,3558,7,0,0,9,11305
1039,37803,18325,19478,42.5,32054,4754,203,116,35,155,37803
1041,13971,6809,7162,40.3,10142,3099,74,213,0,79,13971
1043,80403,39849,40554,40.1,77178,869,333,371,32,459,80403
1045,50129,24827,25302,36.0,37588,9834,159,662,74,380,50129
1047,43572,20042,23530,37.3,12738,30057,68,150,8,190,43572
1049,70949,34974,35975,37.9,64778,1236,1019,209,5,2156,70949
1051,79330,38822,40508,37.7,60119,16036,327,452,0,1123,79330
1053,38122,19686,18436,38.7,24024,12280,1418,142,15,12,38122
1055,104317,50374,53943,40.2,85430,15745,354,696,46,459,104317
1057,17219,8473,8746,43.1,14921,1942,38,58,0,0,17219
1059,31664,15547,16117,38.3,28001,1469,157,64,0,1650,31664
1061,26769,13024,13745,42.2,23239,2632,87,30,0,410,26769
1063,9067,4284,4783,41.4,1608,7421,25,13,0,0,9067
1065,15750,7489,8261,40.4,6292,9327,32,48,14,0,15750
1067,17275,8225,9050,42.9,11888,4812,0,349,0,138,17275
1069,101459,48655,52804,38.3,71132,26052,300,865,18,1302,101459
1071,53279,26341,26938,41.4,49024,1770,1037,198,20,196,53279
1073,658464,311658,346806,37.0,351974,277856,1238,9745,87,12042,658464
1075,14513,6993,7520,42.6,12655,1728,4,3,0,9,14513
1077,92528,44344,48184,40.4,80665,9372,430,697,0,400,92528
1079,34148,16696,17452,41.0,26490,3803,1892,49,0,231,34148
1081,140938,69643,71295,29.6,101299,32324,501,3834,67,924,140938
1083,83313,42264,41049,38.7,68300,10670,431,928,3,1722,83313
1085,11304,5284,6020,40.7,2874,8365,23,0,0,20,11304
1087,21214,9687,11527,36.6,3365,17635,42,0,0,25,21214
1089,334661,164288,170373,37.3,232397,80303,2262,8084,303,2623,334661
1091,20909,9816,11093,41.1,9688,10926,13,39,0,128,20909
1093,30641,15138,15503,43.2,28907,1189,48,121,0,37,30641
1095,93070,45911,47159,38.1,87176,1498,696,504,61,1809,93070
1097,412297,197997,214300,36.6,250617,143332,3443,7742,43,2016,412297
1099,22993,11135,11858,40.0,12748,9534,288,82,0,94,22993
1101,229376,109021,120355,34.7,93483,125397,891,4679,59,1829,229376
1103,119330,58488,60842,38.7,98477,14197,1185,753,115,2347,119330
1105,10525,5105,5420,37.0,3185,7223,0,31,0,10,10525
1107,19646,9284,10362,41.4,11249,8168,16,4,0,12,19646
1109,32750,15499,17251,31.3,19268,11915,258,616,0,46,32750
1111,22843,11142,11701,40.7,17656,4758,96,16,0,49,22843
1113,53938,25974,27964,35.6,29342,22756,40,240,51,369,53938
1115,83530,41802,41728,38.8,74235,7415,406,519,19,244,83530
1117,195237,95447,99790,36.9,162400,21002,639,4044,24,5129,195237
1119,13669,6160,7509,37.1,3327,10132,12,94,0,58,13669
1121,82194,40050,42144,39.4,53935,26762,252,123,0,254,82194
1123,41534,20098,21436,41.8,29403,11347,52,19,0,246,41534
1125,194254,93972,100282,31.4,130821,58198,482,2499,7,701,194254
1127,67016,32559,34457,41.5,61305,3672,154,166,0,391,67016
1129,17407,8695,8712,39.5,11389,4263,1364,107,40,58,17407
1131,11706,5595,6111,38.8,3132,8555,0,0,0,4,11706
1133,24432,11918,12514,43.1,23567,196,121,43,0,70,24432
2013,3114,2301,813,40.7,721,417,570,1258,19,34,3114
2016,5507,3666,1841,39.1,1860,326,837,1561,114,439,5507
2020,291470,147903,143567,32.9,194690,16770,19326,23312,5824,4302,291470
2050,17184,8943,8241,26.1,2007,49,14031,181,65,0,17184
2060,929,496,433,42.7,507,2,288,3,5,2,929
2068,1917,989,928,41.4,1677,20,75,60,0,3,1917
2070,4887,2546,2341,28.6,888,19,3381,38,21,57,4887
2090,97523,51550,45973,30.7,75945,4482,6458,2460,396,1007,97523
2100,2500,1397,1103,42.9,2053,8,183,26,0,0,2500
2105,2153,1119,1034,48.3,1041,5,767,25,8,20,2153
2110,31636,16133,15503,37.8,22095,215,3560,1743,248,320,31636
2122,55474,29000,26474,40.9,47050,322,4453,783,37,252,55474
2130,13525,7031,6494,38.4,9154,58,1824,811,10,149,13525
2150,13710,7395,6315,31.5,7799,105,2123,2733,108,274,13710
2164,1551,751,800,28.7,431,7,987,28,4,1,1551
2170,89319,46172,43147,34.8,76133,907,4273,1148,202,416,89319
2180,9580,5144,4436,28.0,1597,126,6884,83,31,16,9580
2185,9317,5845,3472,34.2,3010,46,4929,413,124,105,9317
2188,7601,4080,3521,25.7,868,30,6146,51,8,1,7601
2195,3822,2007,1815,42.2,2754,50,470,84,0,88,3822
2198,5603,3074,2529,39.0,2791,12,2311,44,20,27,5603
2220,8909,4460,4449,38.8,5869,70,1544,468,2,121,8909
2230,1050,549,501,46.7,799,3,17,177,0,0,1050
2240,7039,3839,3200,36.3,5694,107,735,62,26,51,7039
2261,9614,5217,4397,39.6,7090,28,1454,346,31,126,9614
2270,7556,3970,3586,21.8,235,8,6843,8,23,0,7556
2275,2368,1127,1241,50.8,1744,13,335,36,10,2,2368
2282,644,370,274,39.1,248,8,283,4,5,5,644
2290,5637,3053,2584,35.6,1235,6,3889,22,22,18,5637
4001,71618,35672,35946,32.1,17177,207,52153,251,71,682,71618
4003,131118,66837,64281,39.9,105267,5164,1454,2286,362,9691,131118
4005,134011,66429,67582,30.9,83919,1774,36501,1955,138,5737,134011
4007,53436,26751,26685,47.8,42288,238,7831,140,26,1687,53436
4009,37115,19936,17179,31.8,27973,776,5044,176,112,2105,37115
4011,8592,4505,4087,33.7,7410,84,177,51,0,631,8592
4012,20460,10332,10128,54.1,14643,181,2621,135,14,2644,20460
4013,3841819,1901825,1939994,34.6,3114615,192883,71329,133497,7964,218094,3841819
4015,201216,101109,100107,47.4,179349,2019,3062,2066,297,6177,201216
4017,107415,53736,53679,34.8,52280,916,45544,530,104,4313,107415
4019,981048,482244,498804,37.7,778258,35850,31265,26302,1273,79703,981048
4021,368374,193667,174707,35.8,284721,16664,19809,6126,1681,28697,368374
4023,47057,22375,24682,35.5,34441,262,134,272,34,10871,47057
4025,211280,103607,107673,49.3,193691,1182,4176,1612,82,5257,211280
4027,196420,98901,97519,33.6,149922,4084,2705,2199,348,32562,196420
5001,19029,9166,9863,41.5,13791,4656,27,123,11,211,19029
5003,21811,10561,11250,39.5,15143,5613,49,28,0,667,21811
5005,41387,19893,21494,50.8,40189,123,231,204,7,120,41387
5007,222028,109694,112334,34.5,191672,2557,3325,6353,591,11348,222028
5009,37032,18140,18892,41.4,35767,114,240,193,0,81,37032
5011,11510,5576,5934,40.2,7005,3193,118,0,0,1106,11510
5013,5373,2788,2585,42.4,3972,1307,0,0,0,2,5373
5015,27321,13400,13921,44.2,25062,46,227,102,0,1238,27321
5017,11759,5752,6007,42.5,4875,6404,6,24,0,358,11759
5019,23050,10989,12061,33.6,16982,5494,85,135,0,71,23050
5021,15981,7827,8154,42.9,15623,38,52,7,0,66,15981
5023,25849,12727,13122,46.4,25198,102,82,19,13,15,25849
5025,8685,4295,4390,40.2,7469,1043,0,0,0,40,8685
5027,24644,11782,12862,36.1,14864,9072,48,206,4,37,24644
5029,21203,10450,10753,40.4,18103,2490,153,36,0,105,21203
5031,96709,47118,49591,33.1,80792,12750,318,1215,27,272,96709
5033,61670,30457,31213,38.0,56227,859,811,928,0,817,61670
5035,50618,24105,26513,33.8,23299,25831,35,87,62,576,50618
5037,17891,8557,9334,39.4,13350,4123,47,110,0,17,17891
5039,8122,4125,3997,42.9,4504,3495,6,41,0,76,8122
5041,12922,6093,6829,39.1,6203,6201,37,0,0,361,12922
5043,18615,8948,9667,37.5,12943,5271,12,112,0,84,18615
5045,113730,55936,57794,31.4,97018,11872,499,1541,35,706,113730
5047,18110,8855,9255,40.8,17262,156,126,55,0,29,18110
5049,12301,6030,6271,46.9,11946,36,41,105,0,0,12301
5051,96249,46616,49633,44.2,82114,8043,599,844,14,3074,96249
5053,17852,8824,9028,39.4,17058,364,43,91,0,108,17852
5055,42224,20849,21375,37.8,40966,279,170,32,0,195,42224
5057,22548,10945,11603,38.6,14623,6811,40,5,0,651,22548
5059,33011,16831,16180,39.6,28582,3602,120,24,0,76,33011
5061,13790,6592,7198,37.1,9609,2943,152,42,0,989,13790
5063,36572,18018,18554,38.0,34681,996,237,34,18,176,36572
5065,13614,7040,6574,47.3,13053,163,24,27,49,17,13614
5067,17885,8861,9024,40.9,14355,2945,77,40,6,113,17885
5069,76836,37775,39061,37.2,32332,42307,101,638,75,472,76836
5071,25554,12421,13133,37.6,24127,413,174,74,79,175,25554
5073,7618,3692,3926,42.9,4683,2846,11,0,6,0,7618
5075,17314,8484,8830,39.8,16894,114,32,0,0,9,17314
5077,10430,5781,4649,39.8,4408,5888,34,0,0,94,10430
5079,14167,8628,5539,37.7,9410,4182,27,0,0,290,14167
5081,13068,6352,6716,41.1,9722,2863,70,0,0,106,13068
5083,22352,11150,11202,41.7,20969,308,234,407,0,111,22352
5085,68274,33593,34681,35.5,61297,4248,478,451,0,672,68274
5087,15674,7834,7840,40.4,14975,27,80,81,0,158,15674
5089,16712,8274,8438,50.2,16183,39,72,51,0,79,16712
5091,43449,21398,22051,37.5,31577,10581,158,264,0,163,43449
5093,46388,22376,24012,34.6,29435,15855,78,170,9,156,46388
5095,8145,3871,4274,43.5,4612,3422,30,2,0,52,8145
5097,9453,4626,4827,46.4,8996,47,129,1,0,107,9453
5099,9003,4456,4547,39.6,6034,2857,33,0,0,0,9003
5101,8286,4211,4075,46.6,7862,38,64,0,0,29,8286
5103,25894,12219,13675,42.6,14835,10423,61,24,0,37,25894
5105,10413,5181,5232,42.1,9893,237,58,0,0,49,10413
5107,21646,10140,11506,37.3,7776,13587,16,18,0,40,21646
5109,11261,5645,5616,39.8,10126,397,96,14,0,517,11261
5111,24506,11885,12621,39.6,22270,1782,49,15,0,68,24506
5113,20535,10048,10487,43.4,19127,19,364,23,7,468,20535
5115,61853,30790,31063,35.3,55942,2098,505,435,0,1559,61853
5117,8659,4263,4396,44.6,7455,1119,0,11,0,16,8659
5119,383185,183991,199194,36.0,227501,134065,1116,7877,90,5597,383185
5121,17992,8748,9244,41.3,17475,54,30,76,1,45,17992
5123,28089,15265,12824,36.9,12627,14580,62,55,12,351,28089
5125,107498,53147,54351,38.7,98384,5011,602,982,24,1048,107498
5127,11170,5733,5437,41.4,10037,22,158,449,0,208,11170
5129,8146,4025,4121,47.1,7858,26,69,19,0,0,8146
5131,125795,61720,64075,36.6,104479,7356,1144,5161,117,1670,125795
5133,16978,8335,8643,33.9,11668,749,320,77,0,3851,16978
5135,17278,8456,8822,46.4,16633,50,115,46,35,23,17278
5137,12480,6185,6295,46.9,12119,9,17,109,0,29,12480
5139,41594,20145,21449,39.8,26841,13703,128,225,0,108,41594
5141,17223,8528,8695,46.5,16554,173,163,11,0,117,17223
5143,204057,101885,102172,31.1,163956,6970,2239,4637,4205,17155,204057
5145,77007,37646,39361,36.1,70618,3246,186,263,12,1006,77007
5147,7262,3487,3775,43.3,5034,2086,13,0,7,15,7262
5149,22033,11023,11010,38.4,18553,273,37,315,0,2527,22033
6001,1515136,742993,772143,36.6,695847,185614,8456,400465,12674,127772,1515136
6003,1197,669,528,43.2,852,0,236,32,22,40,1197
6005,37764,20542,17222,48.4,33302,985,778,486,49,1239,37764
6007,220101,108961,111140,37.3,184653,3206,2276,9241,411,7128,220101
6009,45507,22871,22636,49.5,41343,476,438,638,20,1081,45507
6011,21329,11019,10310,33.9,15448,177,259,223,45,3979,21329
6013,1052047,513441,538606,38.5,670524,96210,4656,152283,4860,70257,1052047
6015,28496,15677,12819,38.8,21248,1085,1545,866,139,1867,28496
6017,180441,90422,90019,43.5,157401,1354,1790,6183,104,7018,180441
6019,930517,464903,465614,30.7,546915,47376,9490,88770,1278,199019,930517
6021,28078,14207,13871,36.5,22848,236,742,680,4,2639,28078
6023,134317,67287,67030,37.5,111415,1647,7739,3205,467,3210,134317
6025,173487,89318,84169,31.8,120511,5643,2724,2680,151,36040,173487
6027,18474,9396,9078,45.7,14805,165,1943,269,99,880,18474
6029,839153,432484,406669,30.7,599768,46649,9776,34451,1052,116770,839153
6031,151982,85499,66483,31.2,110937,10470,1901,5737,278,16561,151982
6033,64360,32529,31831,44.8,53781,1495,1996,719,118,3992,64360
6035,34628,22681,11947,37.4,24395,2931,1191,451,224,4111,34628
6037,9840024,4852259,4987765,34.8,5229697,839837,49624,1360561,25973,1983608,9840024
6039,150615,72557,78058,33.2,121838,5248,2650,3012,520,11990,150615
6041,252759,124430,128329,44.6,201272,7284,667,14407,515,19668,252759
6043,18193,9130,9063,49.4,16132,141,669,272,39,342,18193
6045,87577,43930,43647,41.7,72842,804,4200,1583,169,4779,87577
6047,256398,129131,127267,29.7,173461,9794,2622,19278,579,42488,256398
6049,9545,4829,4716,46.8,8417,129,288,36,0,332,9545
6051,14181,7516,6665,37.1,11856,82,476,111,28,1134,14181
6053,416199,214090,202109,32.9,309794,12568,3864,26195,1977,46587,416199
6055,136644,68206,68438,39.6,109393,2758,979,9450,485,9333,136644
6057,98521,48924,49597,48.0,91584,393,934,1386,192,1391,98521
6059,3021840,1495127,1526713,36.2,1886224,48985,12708,547024,9575,421154,3021840
6061,350074,170983,179091,40.2,295714,4270,2579,21683,824,11597,350074
6063,19926,10031,9895,49.4,18139,253,428,234,172,213,19926
6065,2192982,1091924,1101058,33.7,1455085,138216,22688,130982,6965,353226,2192982
6067,1422348,696786,725562,34.9,853146,143842,12829,205867,14435,105623,1422348
6069,55467,27693,27774,34.1,46065,826,569,1299,0,4820,55467
6071,2041029,1015499,1025530,31.7,1272922,178176,21023,130176,6484,342488,2041029
6073,3100500,1556457,1544043,34.7,2217577,156645,21872,342886,14541,206280,3100500
6075,807755,409803,397952,38.5,409445,48419,3690,270503,3485,38968,807755
6077,687036,342120,344916,32.6,410319,50463,6760,98513,3557,74101,687036
6079,270121,138319,131802,39.3,227208,5809,2724,9147,315,16050,270121
6081,721183,354728,366455,39.3,425330,20231,2733,180081,10614,49893,721183
6083,423594,212662,210932,33.6,324705,8396,4674,20775,897,48057,423594
6085,1788393,898013,890380,36.2,901689,46543,9860,577249,6432,169797,1788393
6087,262340,130813,131527,36.9,215815,2707,1325,10910,407,20638,262340
6089,177693,87442,90251,41.9,155637,1633,4116,4720,319,3619,177693
6091,3163,1552,1611,51.6,2949,36,10,4,18,133,3163
6093,44673,22262,22411,47.0,38804,555,1235,601,168,500,44673
6095,414209,206891,207318,37.0,218264,58858,2186,61211,3642,40287,414209
6097,483456,237760,245696,39.8,391986,7739,5785,19747,1497,39827,483456
6099,515115,254802,260313,32.8,398065,14493,5044,26609,3748,44810,515115
6101,94615,47074,47541,34.5,63070,1667,1362,13240,280,9315,94615
6103,63200,31428,31772,39.6,54624,376,1518,704,57,3272,63200
6105,13693,7015,6678,49.2,12130,119,185,168,37,131,13693
6107,441877,221571,220306,29.7,351770,7163,5545,14715,437,46744,441877
6109,55205,28964,26241,48.0,48178,1131,913,609,64,2157,55205
6111,822794,408800,413994,36.4,600242,14795,8733,57239,1360,107010,822794
6113,200873,98020,102853,30.5,134265,5054,2417,25873,1171,20694,200873
6115,72244,36580,35664,31.9,50907,2003,1085,5104,263,7561,72244
8001,442996,222869,220127,32.4,351099,14084,4751,15792,546,40122,442996
8003,15750,7949,7801,32.2,12652,115,182,152,14,1409,15750
8005,574357,281842,292515,35.7,432797,57554,4743,28224,1174,26112,574357
8007,12109,6290,5819,47.5,10827,58,85,117,9,464,12109
8009,3783,1874,1909,47.8,3580,16,33,30,2,44,3783
8011,6192,3997,2195,40.6,4985,525,169,85,0,287,6192
8013,297218,149296,147922,35.6,260736,2667,1170,11927,122,12448,297218
8014,55913,27831,28082,36.5,48998,446,144,2881,14,1032,55913
8015,17879,9517,8362,47.3,16799,500,140,60,0,260,17879
8017,2095,1005,1090,41.0,2056,5,5,11,0,4,2095
8019,9059,4804,4255,45.8,8566,33,58,45,0,154,9059
8021,8241,4093,4148,38.2,6857,6,71,13,0,463,8241
8023,3556,1837,1719,47.4,2922,12,23,23,0,162,3556
8025,5747,4027,1720,39.4,4777,441,94,45,14,261,5747
8027,4208,2270,1938,52.7,4107,38,10,14,0,17,4208
8029,30710,15475,15235,46.1,28977,306,194,174,0,647,30710
8031,604356,302462,301894,33.7,444522,61274,7162,20729,732,50672,604356
8033,1806,950,856,46.5,1745,0,19,4,2,0,1806
8035,286883,142045,144838,36.7,261685,3202,790,11183,92,2728,286883
8037,51850,27710,24140,34.2,46717,156,228,559,0,3268,51850
8039,23058,11525,11533,43.0,21930,73,163,163,3,159,23058
8041,622816,310786,312030,34.1,508314,37927,4847,16102,1808,21592,622816
8043,47006,27576,19430,43.0,39965,2791,904,495,59,1938,47006
8045,56330,29111,27219,34.7,50756,630,287,323,107,3246,56330
8047,5358,2816,2542,44.5,4983,44,17,21,0,120,5358
8049,14608,7806,6802,41.1,13722,87,66,128,12,442,14608
8051,15385,8343,7042,34.3,14660,121,59,113,0,232,15385
8053,790,357,433,56.5,783,0,0,0,0,0,790
8055,6730,3388,3342,51.5,4700,137,426,50,0,486,6730
8057,1397,749,648,46.5,1351,4,10,6,0,15,1397
8059,536095,266072,270023,40.2,484284,5837,4040,13889,251,14133,536095
8061,1393,673,720,40.1,1366,2,2,11,0,0,1393
8063,8210,4691,3519,39.0,7668,259,65,25,7,105,8210
8065,7372,3759,3613,34.2,5804,75,176,55,10,1075,7372
8067,51443,26134,25309,37.7,44963,246,3240,364,39,1539,51443
8069,300870,149595,151275,35.4,274662,2504,1719,5507,340,7522,300870
8071,15385,7908,7477,44.2,13203,175,325,79,37,1037,15385
8073,5443,3197,2246,39.4,4657,499,119,9,19,64,5443
8075,22541,12339,10202,37.5,21164,327,64,143,6,394,22541
8077,146562,73060,73502,37.9,132245,956,1584,970,159,6686,146562
8079,702,327,375,60.3,680,9,5,1,0,6,702
8081,13547,7017,6530,36.4,12550,47,287,111,14,340,13547
8083,25424,12481,12943,42.8,21409,26,2841,151,0,301,25424
8085,40994,20134,20860,42.6,37310,260,308,227,49,1552,40994
8087,28200,14061,14139,36.0,25478,728,175,44,19,1187,28200
8089,18791,9327,9464,40.6,16837,76,597,82,0,825,18791
8091,4445,2259,2186,52.4,4342,0,13,26,0,0,4445
8093,16168,8412,7756,47.0,15566,5,91,137,24,13,16168
8095,4380,2186,2194,40.8,4180,16,18,19,0,81,4380
8097,17000,8993,8007,43.0,16226,94,130,203,2,172,17000
8099,12539,6210,6329,36.7,11707,38,72,52,0,379,12539
8101,159072,78226,80846,38.8,130563,3148,3020,1035,134,14625,159072
8103,6728,3480,3248,36.8,6406,48,103,22,0,46,6728
8105,11925,5875,6050,41.8,9541,69,300,37,2,1612,11925
8107,23385,12354,11031,39.4,22494,91,72,273,0,178,23385
8109,6189,3159,3030,43.8,5010,29,91,13,4,644,6189
8111,747,456,291,37.9,709,0,4,7,0,15,747
8113,7432,3934,3498,38.2,7181,15,29,118,0,16,7432
8115,2389,1182,1207,47.9,2291,6,2,13,5,28,2389
8117,27753,15155,12598,36.3,25241,164,214,276,82,1504,27753
8119,23163,11955,11208,47.4,21938,191,187,216,21,263,23163
8121,4796,2493,2303,44.2,4643,20,48,10,0,30,4796
8123,253552,127009,126543,33.2,225338,2197,2286,3274,100,13473,253552
8125,10032,4901,5131,36.3,9529,15,22,14,0,204,10032
9001,918892,446935,471957,39.5,699870,99871,1439,42880,323,56527,918892
9003,893504,432005,461499,39.9,654726,117181,2327,38823,397,55599,893504
9005,189277,93098,96179,44.4,178558,2229,507,3099,8,1776,189277
9007,165639,80893,84746,43.0,147872,7618,126,4430,82,2094,165639
9009,860995,414726,446269,39.1,649827,107283,2188,30743,416,49374,860995
9011,273723,136457,137266,40.3,226453,14834,1472,11859,188,8268,273723
9013,152137,76843,75294,38.3,136874,4411,135,5101,14,1758,152137
9015,118046,58565,59481,39.4,108037,2233,337,1420,44,2864,118046
10001,162785,78526,84259,36.6,112428,39023,899,3380,141,1882,162785
10003,539665,261385,278280,37.0,363926,128385,1280,23762,223,10510,539665
10005,197681,96427,101254,45.4,157905,25221,698,2035,13,7504,197681
11001,605759,286427,319332,33.9,239413,309263,2143,21440,312,20652,605759
12001,247973,120112,127861,30.1,174623,49795,570,13354,180,2756,247973
12003,27010,14061,12949,35.9,22683,3786,24,142,0,76,27010
12005,168957,83632,85325,39.3,139352,17810,870,3357,130,598,168957
12007,28404,16146,12258,38.7,21868,5856,84,90,0,16,28404
12009,544019,266383,277636,45.5,455284,54218,1477,11054,426,7423,544019
12011,1761993,854675,907318,39.7,1123976,470059,3853,58197,1233,60242,1761993
12013,14639,7822,6817,40.1,11805,2239,203,27,0,183,14639
12015,160380,78022,82358,55.9,145582,8984,335,1921,14,977,160380
12017,140805,68178,72627,54.2,131442,4113,442,2039,18,832,140805
12019,190891,93518,97373,38.2,158179,19132,689,5603,43,1833,190891
12021,323548,159728,163820,47.1,282480,21477,730,3813,60,10670,323548
12023,67546,34914,32632,40.0,52458,11882,309,394,0,795,67546
12027,34628,19562,15066,38.5,27958,4509,39,180,18,1452,34628
12029,16301,8502,7799,44.9,14248,1532,39,46,0,24,16301
12031,866431,420333,446098,35.7,535374,254680,2616,36377,670,12109,866431
12033,298864,147848,151016,37.5,207451,66734,1729,8539,549,2446,298864
12035,95987,46100,49887,47.7,77586,11032,195,2003,101,2881,95987
12037,11545,6684,4861,42.3,9528,1724,16,151,2,59,11545
12039,46823,23112,23711,38.9,17330,26009,135,208,0,2356,46823
12041,16880,8868,8012,39.7,15511,935,38,88,0,72,16880
12043,12952,7240,5712,43.4,10183,1511,502,244,0,497,12952
12045,15796,9026,6770,43.8,12293,2928,91,140,0,134,15796
12047,14728,8747,5981,38.4,8993,5112,39,58,0,252,14728
12049,27347,14962,12385,33.1,22546,2239,232,294,3,1714,27347
12051,38669,20813,17856,32.6,25727,5188,666,280,0,6377,38669
12053,172784,82597,90187,47.8,155885,9205,552,1935,67,2507,172784
12055,98734,48186,50548,51.4,83820,9190,542,1270,77,2181,98734
12057,1238365,604301,634064,36.1,908147,207092,6692,42249,995,38330,1238365
12059,19971,10656,9315,42.1,18111,1077,175,105,78,25,19971
12061,138203,66758,71445,48.9,120601,12313,185,1639,8,1457,138203
12063,49589,27240,22349,40.4,34192,12988,206,238,15,627,49589
12065,14564,7561,7003,43.6,8769,5376,30,12,10,191,14564
12067,8668,4917,3751,33.8,6994,1334,0,33,0,307,8668
12069,297995,144403,153592,45.7,249767,28631,986,5226,219,6673,297995
12071,624155,306462,317693,45.5,526198,50514,2496,9476,103,24665,624155
12073,276506,131436,145070,29.6,174433,83628,1070,8399,112,3017,276506
12075,40541,20041,20500,45.2,35253,3791,79,203,4,263,40541
12077,8300,5179,3121,38.2,6300,1316,115,66,0,221,8300
12079,19187,10087,9100,40.2,10866,7463,70,42,94,369,19187
12081,324834,157221,167613,45.6,271678,28052,780,5591,159,13113,324834
12083,331987,159268,172719,47.4,270917,41173,1261,4544,129,8629,331987
12085,146497,72303,74194,49.8,128266,8288,895,1374,33,5600,146497
12086,2512219,1217277,1294942,38.2,1881017,477618,3843,40005,779,73851,2512219
12087,73475,39243,34232,46.4,66362,4769,137,778,3,615,73475
12089,73303,35957,37346,43.1,66088,4949,142,628,25,383,73303
12091,183400,92159,91241,37.7,148726,16290,1068,5886,322,3339,183400
12093,39779,20998,18781,39.0,33833,3393,286,158,0,1503,39779
12095,1153795,568132,585663,33.7,752892,238585,3656,56129,1263,69884,1153795
12097,272355,133726,138629,35.4,204701,31134,670,7160,33,18925,272355
12099,1324085,641215,682870,43.5,1009367,229313,2436,31527,636,28128,1324085
12101,465276,226155,239121,43.8,416723,20425,1626,10165,374,5868,465276
12103,917389,440405,476984,46.3,765829,94304,2293,27673,786,8309,917389
12105,604562,296505,308057,39.8,475978,89051,1943,10100,269,15587,604562
12107,74224,36885,37339,43.2,57520,12212,254,487,58,2436,74224
12109,191495,93019,98476,42.2,171489,10158,380,3754,336,1447,191495
12111,278246,136049,142197,42.5,203117,52361,1328,4368,94,8645,278246
12113,153086,77370,75716,39.2,134013,7958,1114,3265,157,1129,153086
12115,380479,181497,198982,52.6,347224,17619,848,5125,118,3939,380479
12117,423389,205160,218229,38.3,341546,46044,1016,16382,308,6885,423389
12119,94240,48867,45373,63.0,82441,9198,270,718,54,811,94240
12121,42287,21462,20825,42.2,35519,4902,84,160,0,465,42287
12123,22561,12503,10058,41.2,17081,4821,144,152,39,64,22561
12125,15400,9912,5488,39.8,11435,3197,72,144,3,226,15400
12127,495581,241890,253691,45.3,407410,51487,1665,8006,244,17859,495581
12129,30449,16652,13797,39.5,25186,4246,165,183,0,152,30449
12131,55349,28333,27016,43.0,48450,3037,447,529,124,1513,55349
12133,24732,13317,11415,40.8,19760,3565,175,104,0,141,24732
13001,18279,9243,9036,38.8,13655,3563,25,138,12,833,18279
13003,8355,4181,4174,34.2,5499,1418,2,0,0,1241,8355
13005,11124,5497,5627,35.7,8608,1810,0,69,8,603,11124
13007,3483,1583,1900,41.9,1497,1981,0,0,0,0,3483
13009,46378,23226,23152,34.2,25696,19335,61,721,0,262,46378
13011,18250,9322,8928,38.2,17046,507,14,198,0,348,18250
13013,69136,34593,34543,33.6,55517,8396,128,2245,0,1451,69136
13015,99872,49331,50541,36.7,82548,10000,467,727,63,4593,99872
13017,17612,8516,9096,38.0,10546,6253,0,7,0,289,17612
13019,19131,9482,9649,37.9,16048,2126,12,38,0,470,19131
13021,155560,73194,82366,35.5,68053,80153,341,2522,93,1587,155560
13023,13009,6249,6760,38.7,8957,3666,11,267,0,84,13009
13025,18279,9168,9111,37.9,17389,750,25,72,0,0,18279
13027,16066,7838,8228,40.6,9550,5730,6,58,0,564,16066
13029,30616,15176,15440,36.1,24518,4247,71,491,0,278,30616
13031,70360,35030,35330,25.8,47002,19530,206,1050,0,1450,70360
13033,23242,11193,12049,35.5,11129,11588,16,30,0,233,23242
13035,23671,12624,11047,38.2,16604,6773,0,54,0,113,23671
13037,6581,3875,2706,38.8,2254,3937,33,40,0,267,6581
13039,50435,25815,24620,31.6,37892,9831,236,724,161,213,50435
13043,11007,5379,5628,37.6,7509,2665,29,96,0,629,11007
13045,110750,54024,56726,33.6,85848,20175,327,905,0,1561,110750
13047,64226,31180,33046,38.7,60234,1534,251,735,12,342,64226
13049,12954,7357,5597,38.0,9561,3202,41,0,0,94,12954
13051,266344,128388,137956,34.0,144797,107233,569,6563,146,2792,266344
13053,11917,7337,4580,23.8,7977,2451,155,305,34,538,11917
13055,25905,13424,12481,39.5,22024,2914,16,135,16,377,25905
13057,215014,106123,108891,36.4,188736,12306,995,3573,46,5195,215014
13059,117762,55928,61834,25.9,77350,30810,109,4736,6,1966,117762
13061,3174,1547,1627,42.7,1107,1999,0,0,0,0,3174
13063,262066,125364,136702,31.7,54981,171921,694,13415,180,14396,262066
13065,6800,3245,3555,37.1,4740,1940,20,0,0,0,6800
13067,691820,336597,355223,35.4,436938,173854,1648,31210,402,34366,691820
13069,42566,21635,20931,34.8,27307,11642,83,253,0,3025,42566
13071,45531,22573,22958,34.9,31150,10448,21,272,12,3374,45531
13073,124665,60613,64052,36.9,95752,19294,352,5294,90,1142,124665
13075,17073,8219,8854,36.5,11531,4772,114,28,0,431,17073
13077,127212,62296,64916,36.7,98947,22602,63,1884,0,1554,127212
13079,12701,6516,6185,40.8,9308,2985,104,30,0,12,12701
13081,23460,11300,12160,37.7,12798,10224,48,221,0,57,23460
13083,16598,8179,8419,39.2,15950,211,44,127,0,63,16598
13085,22246,11052,11194,40.5,20992,42,123,156,18,580,22246
13087,27815,13610,14205,37.0,14849,11582,104,87,0,1093,27815
13089,694671,332641,362030,34.3,241091,378457,1947,35251,406,25605,694671
13091,21509,11235,10274,39.5,14721,6452,28,34,0,112,21509
13093,14528,7819,6709,40.7,6568,7505,15,17,0,393,14528
13095,94591,44037,50554,33.4,28204,63492,119,725,0,897,94591
13097,132124,63652,68472,35.0,73116,52129,529,2155,0,1984,132124
13099,10928,5119,5809,39.0,5215,5549,0,30,0,46,10928
13101,4024,1887,2137,32.4,2958,85,0,19,0,956,4024
13103,52203,25733,26470,35.4,43229,7121,199,507,84,486,52203
13105,20103,9566,10537,41.2,13342,6083,40,33,0,507,20103
13107,22600,11129,11471,36.9,13889,7606,97,25,0,763,22600
13109,10935,5289,5646,35.9,6614,3158,33,54,0,968,10935
13111,23554,11533,12021,48.4,22761,138,201,30,18,145,23554
13113,106525,51507,55018,42.3,77040,21297,185,4286,98,933,106525
13115,96204,46604,49600,37.7,75976,13764,520,1270,54,3153,96204
13117,177103,88080,89023,37.0,152592,4819,458,10986,0,5531,177103
13119,22070,10893,11177,40.0,19219,1931,29,129,5,497,22070
13121,929535,453524,476011,34.2,425949,410993,1896,52628,368,21259,929535
13123,28232,14146,14086,42.9,26348,121,69,20,0,1283,28232
13125,3082,1498,1584,39.4,2750,243,0,0,0,0,3082
13127,79628,37872,41756,40.0,53812,20399,140,978,75,2203,79628
13129,55192,27356,27836,36.0,46872,2334,229,557,0,4348,55192
13131,25068,12154,12914,38.2,15532,7289,133,11,0,1775,25068
13133,15988,7934,8054,46.4,9113,6115,26,24,0,498,15988
13135,810624,399993,410631,33.8,427961,189028,2523,86837,477,82432,810624
13137,43038,20133,22905,38.6,38425,1776,116,925,0,1323,43038
13139,180831,90457,90374,34.5,147797,13395,675,3248,41,12602,180831
13141,9422,5244,4178,42.1,2253,7044,6,20,0,77,9422
13143,28627,13975,14652,39.2,26369,1380,27,204,0,242,28627
13145,31870,15896,15974,42.3,25308,5529,92,177,0,206,31870
13147,25277,12515,12762,42.8,19765,5068,7,17,15,191,25277
13149,11756,5898,5858,39.4,10175,1372,0,20,0,0,11756
13151,203185,97585,105600,35.5,113445,73993,299,6313,293,3693,203185
13153,140699,68588,72111,34.4,89223,40147,209,3329,94,3978,140699
13155,9646,4899,4747,37.2,6763,2794,10,0,0,42,9646
13157,60268,29997,30271,36.8,53254,4297,194,1005,84,725,60268
13159,13786,6896,6890,37.7,10129,2953,288,106,0,126,13786
13161,14972,7480,7492,35.7,11812,2279,62,47,27,701,14972
13163,16817,8156,8661,38.1,7017,9671,15,50,0,21,16817
13165,8477,3861,4616,38.6,4987,3028,0,0,0,238,8477
13167,9981,5458,4523,40.2,6183,3519,8,158,0,48,9981
13169,28638,13722,14916,39.1,20960,7187,0,215,0,150,28638
13171,18151,8653,9498,38.2,11927,5668,38,91,0,161,18151
13173,10066,4902,5164,32.7,6956,2398,0,228,0,315,10066
13175,48264,23057,25207,38.0,29711,17311,38,505,0,171,48264
13177,28449,14413,14036,35.9,21884,5382,40,625,0,185,28449
13179,64663,32034,32629,27.6,30711,26948,224,1412,284,2765,64663
13181,7962,3893,4069,45.2,5192,2595,28,27,0,0,7962
13183,14488,6972,7516,30.2,9659,3693,125,32,0,633,14488
13185,109730,53622,56108,29.8,63482,39481,202,1619,28,2292,109730
13187,30040,14965,15075,36.1,28147,496,147,123,0,632,30040
13189,21762,10294,11468,38.5,12564,8829,70,15,0,95,21762
13191,14119,6534,7585,43.5,8569,5084,92,46,0,106,14119
13193,14552,7750,6802,38.9,5239,8872,20,210,0,194,14552
13195,27988,13741,14247,38.8,24544,2244,76,234,0,528,27988
13197,8615,4413,4202,41.2,5203,2854,0,90,81,255,8615
13199,21966,10411,11555,41.6,12810,8823,47,29,0,129,21966
13201,6094,2994,3100,41.2,4216,1822,8,0,0,0,6094
13205,23510,12195,11315,37.2,11478,11320,17,13,6,389,23510
13207,26376,13194,13182,40.7,19299,6300,23,242,0,263,26376
13209,9054,4667,4387,36.8,6402,2440,0,27,0,145,9054
13211,17919,8670,9249,41.3,13039,4466,25,14,0,82,17919
13213,39635,19538,20097,36.5,37118,450,64,129,9,1175,39635
13215,191278,92086,99192,33.4,89502,86320,461,4364,299,3677,191278
13217,100047,47588,52459,34.6,55206,40145,355,1110,3,793,100047
13219,32814,16126,16688,39.1,29073,1802,6,1034,6,365,32814
13221,14745,7369,7376,41.4,11563,2478,18,55,0,104,14745
13223,141846,69339,72507,34.0,112989,24257,431,1129,0,611,141846
13225,27531,13404,14127,33.9,13115,12761,8,245,8,897,27531
13227,29445,14613,14832,41.7,28302,368,149,159,1,279,29445
13229,18631,9174,9457,38.6,16030,1687,39,69,0,571,18631
13231,17765,8708,9057,38.3,15511,1913,55,75,0,30,17765
13233,41350,20529,20821,36.9,33614,5353,50,327,32,1542,41350
13235,11801,5021,6780,43.3,7794,3738,0,12,57,130,11801
13237,21184,10440,10744,44.8,14652,5732,0,46,0,597,21184
13239,2542,1241,1301,40.4,1176,1344,4,6,0,0,2542
13241,16297,7947,8350,45.4,15394,188,25,240,0,234,16297
13243,7596,3776,3820,39.2,2837,4424,1,49,0,17,7596
13245,200337,97042,103295,33.1,79801,109167,694,3352,103,2098,200337
13247,85008,40386,44622,37.2,39185,38888,331,1657,0,3306,85008
13249,4963,2493,2470,37.7,3250,1420,0,110,0,55,4963
13251,14574,7037,7537,39.7,7909,6416,6,10,0,29,14574
13253,8815,4023,4792,43.7,5767,2944,0,47,0,0,8815
13255,63979,30967,33012,37.1,40646,21080,265,578,0,588,63979
13257,26003,12416,13587,40.5,22300,3037,81,238,10,106,26003
13259,5991,3665,2326,41.6,1713,3722,0,5,0,527,5991
13261,32425,15444,16981,34.2,14358,16805,10,439,0,384,32425
13263,6772,3243,3529,45.3,2626,4069,0,15,0,0,6772
13265,1674,783,891,43.4,692,930,0,7,0,11,1674
13267,25023,14317,10706,36.2,16118,7139,71,107,0,1269,25023
13269,8700,4223,4477,40.3,5124,3481,0,5,0,61,8700
13271,16312,9368,6944,39.2,9704,6263,31,29,0,239,16312
13273,9365,4557,4808,40.4,3480,5698,7,38,0,34,9365
13275,44715,21329,23386,39.1,26565,16650,6,365,44,686,44715
13277,40430,19377,21053,34.4,25186,11986,10,570,0,2314,40430
13279,27270,12839,14431,35.7,19068,6826,9,49,0,512,27270
13281,10491,5022,5469,51.3,10116,128,25,22,0,126,10491
13283,6851,3562,3289,37.8,4600,1958,0,56,0,10,6851
13285,67146,32288,34858,36.1,41295,22712,90,1048,0,1109,67146
13287,8834,4446,4388,39.5,5086,3642,0,37,0,33,8834
13289,8984,4359,4625,43.9,4976,3823,15,0,6,118,8984
13291,21344,10331,11013,51.0,20639,261,0,173,8,165,21344
13293,27061,12846,14215,41.0,18858,7560,41,179,0,204,27061
13295,68463,33571,34892,39.6,63347,2987,273,191,0,492,68463
13297,83771,41009,42762,37.4,66919,12912,285,985,17,1181,83771
13299,36099,17932,18167,37.5,24055,10758,105,335,12,555,36099
13301,5788,2621,3167,43.2,2141,3511,0,89,0,0,5788
13303,21092,10705,10387,39.2,9645,11197,0,45,0,50,21092
13305,30157,15788,14369,37.6,22711,6277,32,88,10,648,30157
13307,2773,1384,1389,45.6,1574,1073,0,16,0,12,2773
13309,7572,5096,2476,36.6,4465,3082,5,19,0,0,7572
13311,27141,13527,13614,43.2,25926,616,115,41,30,177,27141
13313,102152,51016,51136,34.0,87385,3843,355,881,0,6926,102152
13315,9142,5319,3823,39.7,5531,3316,33,83,0,119,9142
13317,10398,4929,5469,44.2,5468,4462,141,0,6,230,10398
13319,9577,4590,4987,40.5,5725,3747,9,1,0,59,9577
13321,21746,10378,11368,39.4,15180,6169,18,73,0,49,21746
15001,185399,92982,92417,40.6,60661,1258,562,42542,22227,5590,185399
15003,955215,478888,476327,37.7,201852,20222,2068,421053,89871,8943,955215
15005,66,34,32,58.4,38,0,0,7,12,1,66
15007,67113,33799,33314,41.5,22252,340,196,23690,6536,372,67113
15009,154937,77795,77142,39.5,54276,579,253,40453,15227,1338,154937
16001,394961,197699,197262,34.9,363070,4057,2117,10244,704,4715,394961
16003,3976,2040,1936,50.3,3780,0,81,4,11,2,3976
16005,82584,41140,41444,31.5,74742,587,2845,1025,220,1035,82584
16007,5977,2941,3036,39.6,5829,22,19,0,11,42,5977
16009,9247,4697,4550,44.6,7972,148,773,10,26,28,9247
16011,45312,22637,22675,32.0,40002,113,2530,294,32,1313,45312
16013,21323,10980,10343,40.6,19030,8,369,56,187,1510,21323
16015,7014,3710,3304,48.8,6785,32,92,23,20,0,7014
16017,40806,20514,20292,45.7,39289,127,335,239,31,85,40806
16019,104177,51843,52334,31.8,95952,701,544,705,119,3803,104177
16021,10857,5592,5265,42.6,10238,0,235,71,21,64,10857
16023,2828,1436,1392,45.9,2734,3,3,10,0,7,2828
16025,1276,716,560,38.0,1141,6,27,0,0,64,1276
16027,189396,93836,95560,31.6,173340,582,1356,1548,209,5589,189396
16029,6872,3506,3366,38.1,6569,7,1,33,0,143,6872
16031,22813,11567,11246,32.1,20616,111,139,91,0,1372,22813
16033,780,408,372,37.3,746,0,34,0,0,0,780
16035,8679,4730,3949,49.5,8183,25,207,73,0,27,8679
16037,4338,2344,1994,47.9,4262,0,0,2,12,0,4338
16039,26655,13829,12826,30.3,22359,774,337,542,74,1309,26655
16041,12739,6485,6254,32.0,12111,23,54,11,1,261,12739
16043,13123,6781,6342,33.8,12684,5,103,42,0,134,13123
16045,16768,8466,8302,42.2,15906,2,53,198,35,318,16768
16047,15327,7898,7429,35.0,13326,2,254,72,0,1261,15327
16049,16215,8417,7798,48.3,15317,19,395,18,5,47,16215
16051,25940,13026,12914,30.2,24761,47,187,42,19,519,25940
16053,22140,11227,10913,31.4,19598,35,418,6,0,1714,22140
16055,139083,68443,70640,39.1,132247,283,1685,882,163,412,139083
16057,37365,19293,18072,28.1,34735,251,185,702,31,238,37365
16059,7892,4012,3880,50.0,7624,35,35,67,0,21,7892
16061,3818,1910,1908,47.7,3523,0,138,22,11,0,3818
16063,5167,2635,2532,33.1,4418,30,74,29,0,558,5167
16065,37311,18227,19084,22.7,35753,209,71,292,71,145,37311
16067,19909,10125,9784,35.4,16976,50,155,42,7,2127,19909
16069,39226,19583,19643,41.0,35308,112,2051,344,152,167,39226
16071,4236,2267,1969,39.7,4094,0,27,0,0,7,4236
16073,11479,5961,5518,35.8,10314,0,394,11,0,365,11479
16075,22614,11211,11403,38.0,20991,15,248,106,7,514,22614
16077,7717,3912,3805,34.0,7124,20,118,1,32,341,7717
16079,12797,6440,6357,46.5,12313,17,121,67,0,18,12797
16081,10007,5294,4713,33.9,9625,0,6,160,0,208,10007
16083,77122,38120,39002,34.6,71124,362,522,892,2,2754,77122
16085,9793,5023,4770,46.7,9502,1,10,14,0,43,9793
16087,10144,5033,5111,44.0,9276,0,28,107,0,547,10144
17001,67098,32583,34515,40.4,62707,2418,72,505,0,448,67098
17003,8147,4175,3972,41.0,5012,2833,24,28,0,12,8147
17005,17762,8777,8985,40.4,16286,518,6,253,0,11,17762
17007,54141,27083,27058,36.6,48923,1186,87,802,0,2185,54141
17009,6913,4439,2474,37.2,5570,994,20,36,0,13,6913
17011,34798,17031,17767,42.6,33564,221,116,259,4,344,34798
17013,5065,2554,2511,44.6,4988,4,0,14,0,0,5065
17015,15338,7638,7700,46.5,14775,75,18,58,8,106,15338
17017,13570,6822,6748,37.9,11936,423,6,0,3,1017,13570
17019,200931,100356,100575,28.9,150215,25348,377,18399,15,2064,200931
17021,34805,17649,17156,41.6,33554,501,59,190,10,170,34805
17023,16353,8018,8335,42.8,16059,64,15,55,8,26,16353
17025,13828,6753,7075,42.5,13459,86,64,62,0,28,13828
17027,37793,19414,18379,39.4,35628,1309,71,181,0,126,37793
17029,53683,25801,27882,32.3,50030,2024,41,493,17,140,53683
17031,5197677,2517167,2680510,35.3,2934297,1284262,12224,328072,1241,539082,5197677
17033,19777,10174,9603,42.0,18405,574,121,91,0,90,19777
17035,11044,5528,5516,40.6,10846,56,9,81,6,3,11044
17037,104820,52181,52639,29.4,88160,6526,191,2505,28,5094,104820
17039,16562,8256,8306,42.0,16099,217,4,12,7,123,16562
17041,19908,9792,10116,38.3,19081,82,34,159,0,340,19908
17043,918608,450498,468110,38.2,738739,41842,1429,93861,293,23981,918608
17045,18513,8982,9531,43.0,18169,73,7,122,0,27,18513
17047,6691,3321,3370,43.1,6523,63,0,23,0,0,6691
17049,34258,17050,17208,39.5,33428,87,23,123,0,309,34258
17051,22082,11222,10860,39.7,20711,397,15,276,15,83,22082
17053,14045,6819,7226,42.5,13705,75,25,28,0,57,14045
17055,39518,19475,20043,41.8,38646,69,46,160,0,76,39518
17057,36989,19170,17819,42.3,34996,1268,44,37,19,146,36989
17059,5592,2717,2875,45.0,5430,23,21,12,0,12,5592
17061,13828,6992,6836,41.3,13196,177,0,22,39,79,13828
17063,49870,24912,24958,36.4,47587,539,36,199,0,742,49870
17065,8430,4131,4299,43.3,8312,32,26,0,0,30,8430
17067,19063,9397,9666,44.7,18635,60,80,56,1,27,19063
17069,4315,2329,1986,45.9,4137,34,9,49,0,0,4315
17071,7275,3584,3691,47.6,7038,21,6,25,17,98,7275
17073,50378,24958,25420,41.9,47545,800,87,142,7,1028,50378
17075,29689,14574,15115,43.2,28543,337,59,150,0,329,29689
17077,59992,30342,29650,29.1,46903,8644,251,2002,20,440,59992
17079,9707,4855,4852,42.7,9521,6,11,20,0,74,9707
17081,38908,20019,18889,40.5,34297,3108,82,320,0,212,38908
17083,22939,11246,11693,41.3,22439,153,13,71,0,6,22939
17085,22663,11371,11292,47.2,21981,114,70,100,6,234,22663
17087,12653,7201,5452,42.0,11255,1201,5,30,0,20,12653
17089,514891,256762,258129,34.7,378359,28009,1460,17335,110,78938,514891
17091,113170,55569,57601,36.7,89768,16821,168,1211,22,2701,113170
17093,114226,56847,57379,33.0,96523,6223,310,3527,0,4495,114226
17095,52698,26464,26234,41.8,46433,4144,92,404,6,844,52698
17097,701282,350038,351244,36.7,545712,47655,1476,43978,291,45119,701282
17099,113688,56731,56957,41.1,106771,2012,179,658,0,2025,113688
17101,16778,10497,6281,40.8,12524,3662,34,23,56,227,16778
17103,35778,18626,17152,41.6,32921,1621,41,232,0,327,35778
17105,38903,19409,19494,40.2,35363,2333,10,216,11,525,38903
17107,30278,15508,14770,39.4,25416,3600,17,382,11,476,30278
17109,32568,16178,16390,29.4,29583,1654,65,737,10,129,32568
17111,308163,153700,154463,38.0,279509,3449,550,7927,0,11678,308163
17113,169689,82369,87320,32.2,143872,12198,298,7263,24,1880,169689
17115,110558,53036,57522,40.4,88035,17612,78,1266,16,479,110558
17117,47712,23419,24293,41.9,46523,291,33,166,12,60,47712
17119,268586,131198,137388,38.4,238068,21124,474,2305,24,1377,268586
17121,39319,19154,20165,41.4,36672,1283,52,217,3,100,39319
17123,12567,6227,6340,44.9,12158,52,11,73,0,185,12567
17125,14636,7190,7446,44.3,14366,135,20,51,21,0,14636
17127,15370,7283,8087,42.3,13967,817,16,57,0,44,15370
17129,12728,6208,6520,43.0,12394,116,6,46,0,1,12728
17131,16421,8109,8312,43.7,16058,87,19,45,0,122,16421
17133,33003,16286,16717,40.5,32401,75,22,155,30,16,33003
17135,29977,15794,14183,41.8,27344,2208,20,150,0,86,29977
17137,35544,17836,17708,40.9,32592,2239,41,70,0,28,35544
17139,14844,7247,7597,41.0,14601,58,2,46,21,51,14844
17141,53378,26543,26835,40.9,51392,499,17,312,0,438,53378
17143,186399,90322,96077,36.7,140310,33054,555,5962,14,1818,186399
17145,22287,12129,10158,39.7,19675,1974,89,113,0,166,22287
17147,16679,8238,8441,42.8,16362,82,0,40,0,16,16679
17149,16436,8175,8261,42.0,15919,229,55,50,0,35,16436
17151,4399,2181,2218,47.9,4116,205,0,12,0,1,4399
17153,6107,3015,3092,43.5,3933,2038,4,8,0,11,6107
17155,5968,3022,2946,44.6,5759,40,0,10,0,106,5968
17157,33353,18259,15094,41.2,29543,3243,39,89,19,93,33353
17159,16181,7924,8257,43.6,15719,59,11,199,0,14,16181
17161,147504,72318,75186,40.1,120300,13388,450,2480,9,6878,147504
17163,268873,129473,139400,37.1,175382,81457,478,3058,41,1849,268873
17165,24975,12140,12835,41.8,23288,955,114,132,0,33,24975
17167,197474,94848,102626,39.3,165311,23726,405,3166,41,1129,197474
17169,7499,3867,3632,43.2,7157,72,16,119,0,58,7499
17171,5322,2627,2695,43.1,5222,0,0,7,0,17,5322
17173,22316,11056,11260,44.0,22043,72,17,32,0,10,22316
17175,5983,2939,3044,44.0,5853,20,0,53,0,6,5983
17177,47532,23063,24469,43.7,41559,4316,80,398,14,55,47532
17179,135201,66594,68607,39.9,130374,1225,143,899,21,452,135201
17181,17799,8917,8882,43.3,17067,356,15,28,0,196,17799
17183,81463,40336,41127,39.6,67679,10613,158,471,0,976,81463
17185,11935,5792,6143,42.8,11588,7,0,97,0,55,11935
17187,17723,8676,9047,40.0,16109,460,46,154,7,761,17723
17189,14692,7365,7327,42.4,14346,125,7,13,0,71,14692
17191,16727,8157,8570,42.6,16448,69,8,87,0,22,16727
17193,14686,7056,7630,44.5,14434,96,3,29,0,28,14686
17195,58400,28698,29702,42.0,54057,802,266,283,74,1769,58400
17197,677669,336896,340773,35.5,522369,74036,1227,30643,138,33859,677669
17199,66335,32836,33499,40.4,61672,2618,259,450,12,236,66335
17201,294433,143790,150643,38.4,236835,36087,774,6865,85,6616,294433
17203,38736,19080,19656,40.1,37647,226,35,228,0,226,38736
18001,34343,16996,17347,34.3,33380,123,66,61,0,201,34343
18003,355940,173640,182300,35.4,284804,42209,1140,9621,256,8499,355940
18005,77297,38174,39123,38.1,69578,1410,195,2834,19,1940,77297
18007,8816,4355,4461,39.8,8640,41,0,0,0,40,8816
18009,12742,6291,6451,42.0,12473,48,8,31,0,5,12742
18011,56823,27995,28828,38.5,54190,610,56,1023,0,279,56823
18013,15181,7598,7583,47.3,14834,24,131,32,0,34,15181
18015,20105,10006,10099,41.3,19714,88,0,64,0,62,20105
18017,38875,19413,19462,38.6,35049,610,80,425,6,2194,38875
18019,110100,53806,56294,38.1,97309,7583,171,957,21,1597,110100
18021,26908,13248,13660,40.7,26303,56,53,73,14,34,26908
18023,33179,16321,16858,37.8,31121,218,126,17,0,1223,33179
18025,10702,5436,5266,41.3,10469,52,108,0,0,25,10702
18027,31604,15708,15896,35.7,30491,187,76,181,90,367,31604
18029,49904,24776,25128,40.2,48691,338,99,227,29,116,49904
18031,25772,12786,12986,38.8,25094,120,2,265,0,123,25772
18033,42218,21041,21177,37.9,41066,61,42,173,0,233,42218
18035,117459,56429,61030,34.6,104735,5509,275,1331,18,706,117459
18037,41995,20957,21038,40.6,40838,181,62,148,0,489,41995
18039,198214,97852,100362,34.8,168630,11455,606,2046,35,10581,198214
18041,24220,11835,12385,40.7,23477,293,5,57,0,76,24220
18043,74601,36105,38496,39.2,67975,3463,75,726,59,473,74601
18045,17212,8567,8645,42.0,16766,54,44,61,0,118,17212
18047,23108,11562,11546,39.9,22735,17,41,98,0,78,23108
18049,20762,10348,10414,40.3,19848,205,55,105,4,288,20762
18051,33437,16798,16639,40.2,31782,722,6,39,0,309,33437
18053,69886,33704,36182,39.8,62300,4792,79,374,0,408,69886
18055,33032,16446,16586,41.5,32401,135,87,32,25,131,33032
18057,276098,134873,141225,35.7,245060,9351,390,12952,61,2075,276098
18059,69778,34259,35519,39.0,66516,1443,189,566,0,204,69778
18061,39102,19540,19562,40.7,38199,198,31,208,0,82,39102
18063,145880,72729,73151,36.8,132060,7051,140,2857,48,1219,145880
18065,49381,25403,23978,41.8,47224,710,83,143,15,273,49381
18067,82914,39808,43106,40.7,73579,5902,149,896,82,640,82914
18069,37144,18129,19015,39.3,36125,211,67,199,5,83,37144
18071,42414,21121,21293,38.5,40249,130,168,313,0,839,42414
18073,33369,16675,16694,38.3,32555,248,83,62,0,44,33369
18075,21353,10499,10854,39.1,21007,57,36,3,0,26,21353
18077,32501,15741,16760,40.5,30793,672,0,273,0,487,32501
18079,28373,14290,14083,37.9,27682,75,41,85,0,67,28373
18081,140033,68789,71244,37.1,131240,2044,240,2449,14,1768,140033
18083,38392,19305,19087,38.9,36318,1052,38,185,0,311,38392
18085,77328,38482,38846,37.8,71652,460,204,812,19,3257,77328
18087,37284,18836,18448,30.7,36375,46,17,26,0,178,37284
18089,495230,239123,256107,37.3,308780,126091,1615,6288,97,40264,495230
18091,111335,57603,53732,39.5,95377,11856,249,575,4,1008,111335
18093,46131,22884,23247,41.4,44791,238,108,222,0,270,46131
18095,131244,65445,65799,39.3,115997,8813,116,629,16,1411,131244
18097,904535,436373,468162,33.9,580773,239965,2274,18219,129,37798,904535
18099,47045,23432,23613,38.2,43495,330,82,308,27,2001,47045
18101,10300,5181,5119,42.0,10106,20,18,76,15,3,10300
18103,36850,19664,17186,39.9,33723,1740,370,71,0,276,36850
18105,138048,68589,69459,27.8,121045,4299,505,7589,49,1456,138048
18107,38207,19159,19048,39.5,36772,507,117,169,0,258,38207
18109,69033,34136,34897,39.9,67449,194,84,380,0,258,69033
18111,14199,7177,7022,42.8,13779,37,22,16,16,86,14199
18113,47547,23817,23730,37.1,46044,63,53,222,2,501,47547
18115,6093,3005,3088,43.9,5973,57,0,0,0,0,6093
18117,19828,9820,10008,39.8,19260,263,51,37,0,57,19828
18119,21583,10881,10702,42.7,21148,100,44,97,0,49,21583
18121,17251,8147,9104,41.1,16655,398,29,45,0,11,17251
18123,19408,10327,9081,41.3,18569,506,48,36,0,39,19408
18125,12849,6421,6428,42.8,12777,4,0,38,0,0,12849
18127,164386,80946,83440,38.5,152206,4832,422,2281,45,2190,164386
18129,25840,12843,12997,41.6,25006,329,18,4,0,209,25840
18131,13395,6752,6643,41.6,13040,33,13,45,0,61,13395
18133,37995,20096,17899,38.0,35610,1491,169,316,0,83,37995
18135,26101,12783,13318,41.2,25359,83,16,7,0,225,26101
18137,28702,14046,14656,39.2,28067,97,3,199,0,63,28702
18139,17349,8588,8761,40.3,16914,139,3,53,0,73,17349
18141,266785,129158,137627,36.1,212406,34048,935,4726,171,6220,266785
18143,24044,12000,12044,39.1,23488,117,54,17,0,163,24044
18145,44435,21914,22521,39.9,42021,488,97,300,35,1058,44435
18147,20948,10544,10404,42.3,20214,138,64,129,0,355,20948
18149,23310,11513,11797,40.5,22701,81,44,43,12,151,23310
18151,34116,17265,16851,40.0,31758,264,138,170,7,140,34116
18153,21379,11650,9729,39.4,20060,1061,49,19,0,60,21379
18155,10509,5387,5122,40.6,10265,45,14,0,0,93,10509
18157,173317,88307,85010,27.7,148425,6826,307,10816,38,2800,173317
18159,15917,7837,8080,43.0,15605,41,0,37,0,74,15917
18161,7449,3688,3761,40.2,7214,42,7,39,0,0,7449
18163,179610,86658,92952,37.5,155816,16053,383,1753,9,1194,179610
18165,16224,8039,8185,41.5,15982,21,69,28,0,15,16224
18167,107805,54597,53208,36.2,94906,7250,364,1895,35,770,107805
18169,32804,16025,16779,41.6,31671,219,303,96,0,300,32804
18171,8490,4247,4243,42.6,8297,7,6,18,0,80,8490
18173,59643,29538,30105,39.5,56685,515,131,853,0,383,59643
18175,28162,14109,14053,39.0,27735,125,37,52,0,7,28162
18177,68797,33246,35551,40.5,62191,2239,46,628,0,759,68797
18179,27677,13613,14064,40.3,27086,148,80,30,0,61,27677
18181,24612,12120,12492,42.2,23978,64,60,63,6,128,24612
18183,33234,16653,16581,40.0,32268,160,60,49,0,268,33234
19001,7628,3798,3830,45.4,7457,11,12,46,0,0,7628
19003,4027,1994,2033,46.5,3944,12,6,0,0,10,4027
19005,14285,7210,7075,44.2,13614,39,187,136,0,45,14285
19007,12858,6279,6579,44.2,12500,61,3,38,0,20,12858
19009,6077,2948,3129,46.7,5978,4,33,9,0,4,6077
19011,26044,13004,13040,40.4,25361,65,6,41,0,177,26044
19013,130843,63594,67249,34.6,112517,11774,213,1851,38,1595,130843
19015,26324,13112,13212,40.9,25693,236,66,155,0,23,26324
19017,24294,11920,12374,38.3,23629,200,22,122,45,38,24294
19019,20988,10421,10567,38.9,20494,136,41,109,0,97,20988
19021,20215,10301,9914,36.5,16641,478,23,1173,95,1279,20215
19023,14899,7278,7621,43.6,14687,41,29,41,7,10,14899
19025,9936,4991,4945,47.5,9691,87,11,20,0,14,9936
19027,20751,10049,10702,42.5,20190,85,55,169,8,117,20751
19029,13865,6818,7047,44.8,13536,64,40,12,0,70,13865
19031,18446,9045,9401,42.8,18045,16,11,121,0,66,18446
19033,44083,21350,22733,43.4,41979,554,86,424,0,283,44083
19035,12011,6009,6002,47.3,11650,36,35,24,0,110,12011
19037,12409,6266,6143,43.9,12131,29,110,65,0,16,12409
19039,9286,4706,4580,41.5,9125,91,5,10,0,0,9286
19041,16649,8098,8551,42.8,16053,48,29,67,54,198,16649
19043,18056,8997,9059,44.7,17647,62,24,19,0,46,18056
19045,49074,24157,24917,41.6,46205,1471,73,200,0,243,49074
19047,17100,8621,8479,38.0,15708,108,24,8,0,934,17100
19049,66997,32887,34110,34.3,61805,856,33,1658,15,1461,66997
19051,8718,4330,4388,38.6,8598,9,20,23,0,4,8718
19053,8382,4188,4194,38.4,8012,148,62,63,0,29,8382
19055,17721,8825,8896,41.9,17463,24,11,18,0,2,17721
19057,40268,19549,20719,41.8,36857,2061,97,343,0,127,40268
19059,16778,8354,8424,48.3,16453,58,21,51,73,14,16778
19061,93776,46009,47767,38.7,88413,1359,162,1090,73,103,93776
19063,10263,5180,5083,40.2,9685,92,19,32,14,71,10263
19065,20894,10365,10529,42.3,20208,186,97,81,8,34,20894
19067,16204,7886,8318,43.6,15605,224,0,159,14,31,16204
19069,10650,5307,5343,43.0,9782,19,2,47,0,615,10650
19071,7373,3672,3701,45.4,7153,15,21,2,0,86,7373
19073,9304,4576,4728,45.1,9061,10,3,16,0,89,9304
19075,12431,6097,6334,42.5,12244,25,13,30,0,30,12431
19077,10915,5438,5477,44.9,10631,32,33,3,7,72,10915
19079,15614,7762,7852,42.1,14595,52,158,366,0,258,15614
19081,11320,5668,5652,44.7,10911,7,41,32,0,166,11320
19083,17479,8754,8725,43.6,16853,141,24,134,0,136,17479
19085,14838,7340,7498,42.7,14554,15,36,45,0,14,14838
19087,20242,10207,10035,39.8,18918,428,50,526,0,43,20242
19089,9568,4697,4871,42.4,9385,73,1,40,0,0,9568
19091,9818,4818,5000,44.4,9552,13,7,20,0,55,9818
19093,7113,3578,3535,44.8,7017,16,1,16,0,5,7113
19095,16320,8041,8279,42.3,16042,60,4,30,5,24,16320
19097,19807,9816,9991,43.9,18555,135,21,39,77,35,19807
19099,36823,18915,17908,41.7,35623,451,152,181,4,81,36823
19101,16791,8542,8249,44.0,14773,196,26,1199,0,136,16791
19103,131627,65738,65889,29.3,112878,6122,299,7235,11,2198,131627
19105,20686,10744,9942,42.7,19830,360,126,76,42,106,20686
19107,10480,5224,5256,43.6,10310,32,8,2,0,27,10480
19109,15510,7631,7879,46.9,15243,34,8,73,0,46,15510
19111,35741,17977,17764,42.4,33447,1049,52,176,9,196,35741
19113,211954,104310,107644,36.7,192021,8621,566,3802,63,2152,211954
19115,11448,5816,5632,39.3,10659,125,0,59,13,411,11448
19117,8913,4435,4478,43.8,8790,12,51,12,0,0,8913
19119,11623,5794,5829,38.3,11416,3,20,19,0,74,11623
19121,15630,7776,7854,39.4,15315,91,17,30,0,42,15630
19123,22432,11207,11225,39.3,21394,169,46,154,13,221,22432
19125,33388,16589,16799,38.8,32338,185,99,397,0,26,33388
19127,40568,20366,20202,39.4,35248,756,162,562,8,3212,40568
19129,15028,7502,7526,41.4,14624,82,36,50,0,17,15028
19131,10761,5292,5469,44.6,10615,21,0,27,23,11,10761
19133,9242,4589,4653,46.8,8948,21,36,6,0,19,9242
19135,7979,3982,3997,43.3,7701,50,99,67,0,47,7979
19137,10710,5198,5512,45.2,10413,4,0,11,0,109,10710
19139,42729,21141,21588,38.0,39782,574,124,428,0,1066,42729
19141,14302,7091,7211,44.4,13823,30,36,49,0,142,14302
19143,6413,3163,3250,43.3,6305,42,21,15,0,7,6413
19145,15902,8091,7811,43.8,15046,353,40,143,0,121,15902
19147,9402,4702,4700,42.8,9222,37,28,35,0,0,9402
19149,24911,12286,12625,42.5,24018,36,58,169,0,298,24911
19151,7307,3648,3659,47.3,7145,63,3,3,14,35,7307
19153,431811,211945,219866,34.7,368901,25438,1132,15608,288,9719,431811
19155,92793,45516,47277,38.5,87293,1257,260,625,8,1814,92793
19157,18888,9221,9667,41.3,17997,182,37,342,4,72,18888
19159,5123,2516,2607,45.4,5042,5,24,20,0,0,5123
19161,10307,5064,5243,46.3,10116,75,5,21,4,49,10307
19163,165432,81090,84342,37.4,143495,11980,415,3270,0,1685,165432
19165,12158,5908,6250,45.8,11847,10,8,90,12,44,12158
19167,33776,16987,16789,32.9,31614,175,75,291,0,1296,33776
19169,89734,46321,43413,26.5,79969,2516,131,5530,0,526,89734
19171,17746,8678,9068,42.1,15759,98,1286,59,0,230,17746
19173,6292,3112,3180,44.3,6048,6,29,29,0,101,6292
19175,12525,6043,6482,41.5,12065,270,11,12,0,1,12525
19177,7565,3798,3767,43.8,7442,20,7,26,0,14,7565
19179,35449,17312,18137,39.9,33122,469,68,314,0,894,35449
19181,46239,22500,23739,38.5,44988,218,31,171,31,146,46239
19183,21765,10690,11075,41.9,20625,185,6,58,22,521,21765
19185,6372,3071,3301,45.4,6277,5,6,26,0,0,6372
19187,37895,19346,18549,40.0,34950,1628,65,245,0,382,37895
19189,10800,5331,5469,43.8,10414,94,18,39,2,61,10800
19191,21033,10449,10584,40.2,20345,173,97,195,0,123,21033
19193,101948,50088,51860,35.2,85453,2518,1785,2547,174,6377,101948
19195,7581,3784,3797,43.9,7423,25,1,6,0,23,7581
19197,13173,6506,6667,44.4,12493,32,17,34,30,450,13173
20001,13364,6468,6896,40.8,12512,266,83,85,0,69,13364
20003,8066,4019,4047,43.0,7730,22,11,0,0,0,8066
20005,16854,8176,8678,35.8,15402,886,78,42,0,34,16854
20007,4867,2435,2432,46.4,4708,8,14,0,0,23,4867
20009,27556,13575,13981,40.0,25752,423,59,45,9,770,27556
20011,15060,7503,7557,38.0,14112,438,79,104,0,1,15060
20013,9962,4845,5117,41.9,8578,150,994,51,0,10,9962
20015,65647,32804,32843,37.5,61150,1035,435,486,6,620,65647
20017,2788,1404,1384,45.5,2682,32,23,2,0,12,2788
20019,3654,1862,1792,48.3,3306,29,191,0,0,31,3654
20021,21521,10704,10817,40.5,19587,117,897,82,14,17,21521
20023,2724,1378,1346,49.7,2682,0,5,27,0,0,2724
20025,2198,1048,1150,43.5,2050,4,17,11,7,51,2198
20027,8547,4213,4334,44.1,8279,127,42,13,0,0,8547
20029,9479,4598,4881,43.3,9215,31,26,52,0,47,9479
20031,8553,4267,4286,44.0,8287,56,46,25,10,9,8553
20033,1893,930,963,44.0,1836,0,25,8,0,19,1893
20035,36259,18101,18158,38.4,31749,1054,1002,610,2,904,36259
20037,39133,19569,19564,32.7,36047,847,374,577,0,306,39133
20039,2939,1476,1463,51.4,2849,27,14,7,7,3,2939
20041,19766,9743,10023,41.6,18921,68,117,60,0,52,19766
20043,7931,4018,3913,37.9,7317,274,75,48,2,45,7931
20045,111073,55492,55581,28.3,94812,4218,2517,4301,14,710,111073
20047,3021,1563,1458,43.6,2868,9,0,21,0,77,3021
20049,2856,1427,1429,49.0,2710,24,11,16,0,9,2856
20051,28525,14144,14381,31.8,26895,304,38,330,25,490,28525
20053,6477,3623,2854,44.2,5971,300,19,9,0,31,6477
20055,36608,18556,18052,30.4,31698,871,158,1183,0,1755,36608
20057,33725,17314,16411,30.5,29712,597,301,464,16,1814,33725
20059,25916,12813,13103,38.6,24370,185,121,98,12,328,25916
20061,34110,17209,16901,27.4,23307,6060,208,1231,138,551,34110
20063,2771,1413,1358,48.2,2710,18,3,0,0,5,2771
20065,2617,1308,1309,49.5,2414,92,20,19,9,0,2617
20067,7817,3887,3930,32.6,6588,3,82,0,4,985,7817
20069,5982,2878,3104,35.2,5717,0,0,24,0,112,5982
20071,1234,594,640,49.2,1172,10,0,2,0,14,1234
20073,6654,3245,3409,46.5,6406,11,17,4,0,0,6654
20075,2656,1387,1269,36.7,2554,1,3,0,0,71,2656
20077,5998,2994,3004,43.3,5743,38,46,6,9,73,5998
20079,34572,16792,17780,39.7,31904,399,228,231,0,997,34572
20081,4222,2111,2111,34.3,3686,11,49,25,0,395,4222
20083,1949,980,969,47.9,1931,1,0,0,0,0,1949
20085,13401,6724,6677,41.3,11658,153,885,57,14,59,13401
20087,19036,9710,9326,42.9,18282,46,202,11,0,21,19036
20089,3085,1560,1525,51.7,3004,12,7,24,0,16,3085
20091,546046,266675,279371,36.4,476361,23183,1674,22669,298,8320,546046
20093,3952,2072,1880,35.7,3577,18,9,0,0,206,3952
20095,7876,3938,3938,44.6,7648,42,49,0,0,14,7876
20097,2503,1244,1259,42.3,2422,9,20,2,0,2,2503
20099,21574,10729,10845,40.3,19034,761,189,89,19,109,21574
20101,1666,789,877,45.3,1567,1,29,0,0,41,1666
20103,76286,40569,35717,37.4,64073,6522,790,1137,125,915,76286
20105,3240,1605,1635,46.3,3158,3,5,29,0,0,3240
20107,9613,4769,4844,44.3,9324,40,25,131,0,0,9613
20109,2766,1374,1392,44.3,2617,0,0,94,0,0,2766
20111,34103,16612,17491,32.2,30285,723,88,743,0,1112,34103
20113,29208,14402,14806,41.8,28006,280,168,208,34,124,29208
20115,12565,6294,6271,44.3,12163,110,43,38,21,24,12565
20117,10083,4957,5126,44.9,9839,24,18,85,0,37,10083
20119,4504,2312,2192,40.0,3977,41,6,35,0,351,4504
20121,32546,16107,16439,40.1,31166,425,115,33,0,85,32546
20123,6359,3224,3135,45.1,6252,21,8,22,0,36,6359
20125,35167,17308,17859,39.7,29492,2019,625,250,119,367,35167
20127,5917,2905,3012,47.3,5742,6,57,11,0,15,5917
20129,3207,1631,1576,39.4,2715,40,36,45,0,345,3207
20131,10170,5126,5044,42.4,9932,102,38,0,0,13,10170
20133,16501,8142,8359,40.2,15702,193,75,39,3,53,16501
20135,3102,1505,1597,50.9,2960,11,4,0,0,75,3102
20137,5658,3117,2541,43.4,5208,206,17,21,0,54,5658
20139,16300,8140,8160,42.6,15757,68,99,63,0,46,16300
20141,3852,1913,1939,47.6,3773,12,7,15,20,6,3852
20143,6099,3184,2915,42.3,5928,49,10,0,0,7,6099
20145,6945,3978,2967,42.0,6319,347,23,0,0,70,6945
20147,5579,2762,2817,45.7,5302,10,15,13,1,49,5579
20149,21620,10727,10893,35.1,20419,318,118,192,6,159,21620
20151,9670,4821,4849,40.5,9170,106,51,53,12,70,9670
20153,2555,1274,1281,50.8,2483,5,9,0,0,20,2555
20155,64346,32160,32186,40.0,58660,2004,358,325,14,1421,64346
20157,4965,2426,2539,50.8,4847,6,12,22,0,16,4965
20159,10077,4857,5220,38.7,9206,57,182,121,0,269,10077
20161,71927,37554,34373,24.3,60988,4478,357,3250,162,465,71927
20163,5205,2591,2614,44.4,5017,24,5,13,1,12,5205
20165,3262,1634,1628,49.0,3160,44,24,0,0,3,3262
20167,6926,3470,3456,47.1,6683,67,28,0,0,9,6926
20169,55493,27479,28014,37.9,49150,1680,305,1307,64,1242,55493
20171,4872,2271,2601,43.8,4547,7,31,0,0,197,4872
20173,497062,245595,251467,34.4,388827,44320,4102,19887,290,18269,497062
20175,23013,11762,11251,29.0,15484,1004,190,675,0,5209,23013
20177,177688,86093,91595,38.4,144807,14875,1970,2216,37,5993,177688
20179,2562,1305,1257,46.6,2525,11,0,0,0,2,2562
20181,6036,3037,2999,41.1,5685,65,16,80,0,136,6036
20183,3835,1896,1939,50.4,3721,4,21,8,0,1,3835
20185,4398,2189,2209,45.7,4174,27,37,12,0,96,4398
20187,2200,1115,1085,35.5,1709,23,7,14,0,319,2200
20189,5633,2767,2866,34.8,4254,36,52,42,0,1119,5633
20191,24000,11989,12011,39.9,22882,140,361,12,29,76,24000
20193,7854,3806,4048,36.2,7599,112,12,11,2,33,7854
20195,2977,1489,1488,46.8,2870,12,7,8,0,31,2977
20197,7048,3564,3484,41.6,6800,43,14,10,0,23,7048
20199,1508,750,758,45.1,1497,1,8,2,0,0,1508
20201,5806,2954,2852,46.0,5672,52,34,23,0,7,5806
20203,2239,1241,998,38.3,2190,0,12,6,0,17,2239
20205,9368,4634,4734,44.1,8991,8,71,56,0,22,9368
20207,3311,1650,1661,48.8,3169,0,22,8,0,0,3311
20209,157274,77538,79736,33.0,96905,40125,1255,4167,48,10089,157274
21001,18651,9259,9392,39.4,17806,536,6,36,0,63,18651
21003,20007,9773,10234,39.3,19435,209,44,84,0,95,20007
21005,21442,10402,11040,38.3,20584,581,5,64,0,37,21442
21007,8268,4060,4208,41.6,7866,256,21,34,0,6,8268
21009,42229,20390,21839,39.9,39463,1910,48,230,6,113,42229
21011,11665,5790,5875,40.4,11239,223,0,0,0,94,11665
21013,28613,13808,14805,41.1,27303,678,86,88,0,71,28613
21015,119406,58982,60424,35.7,109741,3395,438,2596,0,1529,119406
21017,20004,9779,10225,40.4,18080,1328,60,64,0,252,20004
21019,49358,24499,24859,41.6,46820,1376,82,241,8,165,49358
21021,28445,13998,14447,40.8,25256,1861,99,234,6,244,28445
21023,8488,4257,4231,39.7,8446,12,10,0,0,0,8488
21025,13922,7008,6914,40.4,13689,73,16,47,17,0,13922
21027,20068,10081,9987,41.8,19197,484,17,39,0,109,20068
21029,74431,36825,37606,38.2,71922,438,229,273,36,562,74431
21031,12748,6401,6347,40.3,12419,80,140,4,0,42,12748
21033,12977,6315,6662,42.2,12078,672,17,18,35,31,12977
21035,37198,17619,19579,33.6,34289,1422,97,717,14,150,37198
21037,90119,44184,45935,36.9,84869,2390,96,615,15,388,90119
21039,5081,2436,2645,43.2,4943,55,64,0,0,0,5081
21041,10851,5551,5300,36.6,10322,134,24,121,0,71,10851
21043,27594,13781,13813,39.2,27108,164,18,84,0,0,27594
21045,15984,7881,8103,41.1,15599,132,33,8,0,47,15984
21047,73722,37795,35927,28.9,53326,15466,357,974,311,937,73722
21049,35555,17408,18147,40.3,33057,1843,52,163,57,68,35555
21051,21833,11721,10112,37.4,20336,1025,122,39,0,90,21833
21053,10244,5060,5184,41.5,9834,126,0,13,0,85,10244
21055,9321,4629,4692,42.4,9104,61,16,3,0,0,9321
21057,6857,3412,3445,43.3,6543,249,0,0,0,6,6857
21059,96711,46961,49750,39.0,88633,4689,98,662,30,899,96711
21061,12141,6085,6056,41.7,11921,146,8,12,8,0,12141
21063,7774,4356,3418,40.9,7468,227,0,6,0,30,7774
21065,14647,7210,7437,41.7,14386,38,36,0,0,0,14647
21067,296766,145843,150923,33.8,227058,42188,694,10168,180,8694,296766
21069,14415,7034,7381,39.9,13995,172,14,0,0,29,14415
21071,39454,19397,20057,39.9,38698,351,60,37,12,92,39454
21073,49399,23991,25408,39.7,41306,5204,35,646,0,1073,49399
21075,6758,3410,3348,42.8,4954,1599,14,96,0,2,6758
21077,8513,4283,4230,39.4,7888,77,0,54,0,357,8513
21079,16892,8305,8587,41.7,16092,347,37,0,0,255,16892
21081,24683,12268,12415,35.3,23770,127,3,10,129,320,24683
21083,37200,18164,19036,40.0,34397,1510,48,135,0,302,37200
21085,25772,12836,12936,39.2,24905,192,12,38,0,271,25772
21087,11309,5542,5767,43.4,10792,299,21,20,0,16,11309
21089,36922,17769,19153,42.0,35913,258,141,148,0,35,36922
21091,8588,4352,4236,40.0,8347,97,15,0,6,40,8588
21093,104513,51819,52694,35.5,84415,12543,289,2398,403,671,104513
21095,29210,14260,14950,40.6,28015,748,67,5,73,119,29210
21097,18781,9129,9652,41.6,17869,446,87,37,0,252,18781
21099,18278,9042,9236,40.6,17082,927,16,17,7,0,18278
21101,46254,22203,24051,39.4,41241,3552,143,137,0,291,46254
21103,15428,7650,7778,40.6,14461,460,62,0,0,201,15428
21105,4869,2378,2491,44.7,4280,498,0,47,0,4,4869
21107,46891,22862,24029,40.3,42516,2750,80,254,202,129,46891
21109,13475,6687,6788,39.0,13354,1,0,0,0,0,13475
21111,741285,357636,383649,37.8,545265,152893,1266,16620,292,7512,741285
21113,48591,23841,24750,35.6,45178,1489,82,449,44,504,48591
21115,23339,11478,11861,39.7,22966,101,18,132,0,28,23339
21117,159926,78908,81018,36.2,145528,7493,326,1542,0,2133,159926
21119,16368,8119,8249,41.1,16048,157,0,28,0,16,16368
21121,31874,15467,16407,38.8,30949,529,70,1,19,112,31874
21123,14175,7156,7019,39.5,13196,468,40,0,0,241,14175
21125,58891,28882,30009,37.6,57259,407,95,317,0,195,58891
21127,15889,7872,8017,39.5,15673,27,0,45,0,0,15889
21129,7831,4345,3486,41.2,7692,73,4,9,0,5,7831
21131,11318,5577,5741,41.8,11155,32,7,16,0,13,11318
21133,24336,11965,12371,41.3,24012,101,12,39,0,30,24336
21135,13889,6919,6970,40.3,13381,107,5,14,0,187,13889
21137,24671,12020,12651,39.2,23517,637,7,84,0,75,24671
21139,9479,4685,4794,44.7,9275,77,8,33,0,8,9479
21141,26786,13130,13656,40.5,24414,2087,11,4,2,52,26786
21143,8336,4616,3720,47.7,7710,557,0,0,0,19,8336
21145,65558,31447,34111,42.1,56034,6400,187,489,34,214,65558
21147,18204,9906,8298,38.6,16582,1152,62,0,18,98,18204
21149,9554,4676,4878,42.2,9393,51,14,0,0,7,9554
21151,83174,40340,42834,33.6,76249,3583,231,915,28,589,83174
21153,13229,6595,6634,39.4,13021,37,34,0,0,0,13229
21155,19872,10312,9560,38.2,17544,1815,0,127,0,204,19872
21157,31393,15435,15958,43.9,30869,112,17,76,0,30,31393
21159,12934,6779,6155,38.6,11776,887,66,3,21,93,12934
21161,17495,8536,8959,40.8,15781,1244,19,20,0,158,17495
21163,28979,14518,14461,35.6,26621,1244,65,222,0,305,28979
21165,6331,3076,3255,41.6,6120,72,14,7,0,42,6331
21167,21283,10146,11137,42.3,20052,761,0,27,0,26,21283
21169,10074,5048,5026,41.9,9707,189,0,0,6,98,10074
21171,10925,5474,5451,42.1,10546,248,0,0,0,18,10925
21173,26517,12798,13719,37.3,25221,830,14,0,0,172,26517
21175,13898,7896,6002,38.6,13074,512,0,53,0,80,13898
21177,31399,15805,15594,41.0,29303,1434,100,12,88,168,31399
21179,43500,21487,22013,37.5,40377,2244,78,151,0,31,43500
21181,7092,3492,3600,39.4,7010,33,0,4,0,45,7092
21183,23975,11890,12085,39.0,22926,367,31,11,0,441,23975
21185,60357,31760,28597,39.2,54997,2652,196,846,36,858,60357
21187,10870,5499,5371,40.6,10615,142,0,22,0,37,10870
21189,4764,2466,2298,43.9,4581,43,0,44,0,0,4764
21191,14771,7347,7424,39.4,14509,69,5,0,0,0,14771
21193,28617,14026,14591,41.2,27619,311,75,158,0,121,28617
21195,64887,31763,33124,40.5,63550,358,28,365,13,151,64887
21197,12638,6340,6298,37.9,12362,116,19,23,0,49,12638
21199,63045,30878,32167,40.9,60544,714,133,286,79,620,63045
21201,2251,1129,1122,38.6,2250,0,1,0,0,0,2251
21203,17090,8441,8649,41.3,16764,70,126,7,0,20,17090
21205,23351,11408,11943,32.0,22261,243,7,141,0,263,23351
21207,17562,8676,8886,41.2,17153,143,47,10,0,70,17562
21209,47211,23037,24174,35.2,42484,2741,125,426,0,792,47211
21211,42286,20345,21941,38.2,36187,3236,62,336,0,1571,42286
21213,17323,8320,9003,38.4,15137,1729,55,122,0,73,17323
21215,17135,8693,8442,39.4,16511,410,52,24,0,9,17135
21217,24514,11812,12702,40.2,22689,1174,31,157,0,50,24514
21219,12472,6171,6301,38.0,11151,1056,4,0,0,137,12472
21221,14282,7081,7201,44.3,12806,1074,21,93,0,0,14282
21223,8829,4493,4336,39.5,8424,157,76,0,0,73,8829
21225,14992,7542,7450,36.6,12813,1845,65,35,0,84,14992
21227,113787,55801,57986,32.7,94913,10438,325,3172,103,2714,113787
21229,11701,5861,5840,40.9,10643,773,30,18,0,95,11701
21231,20819,10329,10490,40.9,19744,395,0,0,18,407,20819
21233,13618,6735,6883,39.7,12640,666,51,16,1,139,13618
21235,35756,17327,18429,37.9,34761,197,1,107,11,119,35756
21237,7298,3589,3709,41.3,7260,2,0,0,0,0,7298
21239,24847,12274,12573,41.7,22122,1399,12,107,2,819,24847
22001,61611,30006,31605,35.6,48543,11184,136,169,70,566,61611
22003,25740,14803,10937,38.5,18791,5194,626,198,0,307,25740
22005,107647,53256,54391,34.4,80220,24118,281,1048,0,946,107647
22007,23321,11395,11926,38.8,15742,7147,68,42,0,125,23321
22009,41925,21008,20917,38.5,28265,12366,436,182,22,93,41925
22011,35662,18145,17517,37.4,29434,4545,249,291,12,110,35662
22013,14312,6832,7480,41.3,7900,5980,81,11,0,82,14312
22015,117742,57873,59869,34.6,85746,25161,804,1736,39,2319,117742
22017,254970,121227,133743,36.3,124850,120654,1025,2751,140,1891,254970
22019,192307,93604,98703,35.9,136839,47988,858,2160,63,1262,192307
22021,10118,5207,4911,40.4,8168,1792,0,14,0,26,10118
22023,6934,3454,3480,40.3,6772,140,0,0,0,0,6934
22025,10409,5531,4878,37.3,7075,3036,41,11,0,43,10409
22027,17059,9469,7590,41.8,8137,8576,60,82,4,35,17059
22029,20624,10394,10230,37.5,11897,8432,40,64,0,9,20624
22031,26695,12720,13975,39.9,15327,10225,228,257,6,288,26695
22033,439662,210853,228809,32.7,217198,199527,611,12657,178,3172,439662
22035,7738,4091,3647,33.1,2266,5401,23,9,0,6,7738
22037,20252,10909,9343,40.6,10784,9143,77,71,0,23,20252
22039,33989,17321,16668,35.7,23497,9623,65,95,0,330,33989
22041,20714,10046,10668,38.8,13919,6691,0,4,0,0,20714
22043,22049,12222,9827,37.4,17680,3478,159,19,25,238,22049
22045,73527,35894,37633,35.6,46219,23331,452,1658,0,438,73527
22047,33386,17023,16363,38.1,16446,16240,30,40,0,107,33386
22049,16210,8203,8007,39.1,11112,4863,25,54,0,8,16210
22051,432706,210026,222680,38.5,274998,114745,2672,17173,198,15873,432706
22053,31529,15418,16111,38.0,25003,5314,95,86,0,239,31529
22055,221602,108072,113530,33.6,155396,56912,549,3274,81,1582,221602
22057,96453,47493,48960,36.7,77363,13000,2599,753,0,1086,96453
22059,14840,7517,7323,38.3,12739,1823,135,29,0,29,14840
22061,46543,22459,24084,27.8,25790,18912,106,823,0,339,46543
22063,128192,63670,64522,34.7,118139,6796,537,571,2,747,128192
22065,12113,6165,5948,34.9,4506,7387,49,10,0,69,12113
22067,27893,13376,14517,38.1,14366,13140,16,36,0,31,27893
22069,39434,18811,20623,33.3,21477,16322,291,174,34,260,39434
22071,341407,164916,176491,34.9,114394,205449,1102,10002,322,5278,341407
22073,153752,73622,80130,34.2,93162,56382,438,1334,27,845,153752
22075,23220,11517,11703,36.6,16492,4891,430,816,0,242,23220
22077,22821,11042,11779,42.5,14120,8343,76,82,0,64,22821
22079,131655,63483,68172,37.4,84258,42313,828,1581,44,704,131655
22081,9068,4319,4749,38.3,5369,3575,16,20,0,0,9068
22083,20785,9969,10816,38.2,13021,7457,12,91,10,8,20785
22085,24265,12058,12207,40.9,17080,4054,1843,74,25,178,24265
22087,35947,18145,17802,33.2,27454,6411,178,788,0,177,35947
22089,52663,25847,26816,36.7,36966,13948,108,459,23,231,52663
22091,11106,5366,5740,39.2,4989,6005,25,0,0,0,11106
22093,21978,10714,11264,38.6,10702,11116,12,82,0,17,21978
22095,45741,22366,23375,35.3,20151,24452,121,257,84,251,45741
22097,83774,40092,43682,36.9,47373,34518,87,364,0,262,83774
22099,52343,25707,26636,36.0,34549,16081,343,462,16,313,52343
22101,54285,26753,27532,37.4,32678,17351,892,852,18,779,54285
22103,234283,114015,120268,39.4,195913,27018,853,3167,101,3315,234283
22105,121209,58797,62412,33.5,81287,36544,424,832,18,803,121209
22107,5189,2450,2739,41.9,2204,2929,0,5,0,47,5189
22109,111666,55226,56440,35.1,78941,20633,5863,1132,39,1818,111666
22111,22633,11043,11590,40.9,16042,6049,82,19,17,171,22633
22113,58041,28324,29717,36.7,47334,8316,256,1217,0,367,58041
22115,51542,26384,25158,30.0,39634,7300,636,877,208,551,51542
22117,47025,23215,23810,38.8,31677,14476,85,80,0,116,47025
22119,41156,20005,21151,40.4,26450,13852,131,166,0,126,41156
22121,23748,11639,12109,35.8,14169,8717,41,102,0,255,23748
22123,11587,5867,5720,40.1,9536,1869,7,33,0,36,11587
22125,15575,10313,5262,42.2,8181,6964,259,13,0,29,15575
22127,15233,7986,7247,39.9,10153,4793,130,1,0,96,15233
23001,107766,52850,54916,39.8,100191,1875,174,675,25,360,107766
23003,71757,35279,36478,45.2,68595,430,998,352,37,164,71757
23005,282143,136955,145188,41.1,262284,7397,580,5931,60,925,282143
23007,30704,15076,15628,43.3,29738,94,76,181,0,20,30704
23009,54470,26600,27870,46.3,52949,153,177,469,0,55,54470
23011,122022,59376,62646,42.7,117567,807,646,1069,34,357,122022
23013,39848,19826,20022,46.6,38703,237,106,230,0,25,39848
23015,34440,16971,17469,48.1,33637,75,53,221,0,58,34440
23017,57814,28742,29072,44.4,56148,251,205,315,40,66,57814
23019,153742,75634,78108,40.0,146522,1137,1649,1415,3,470,153742
23021,17432,8611,8821,48.1,16910,17,58,136,0,37,17432
23023,35394,17167,18227,43.8,33962,344,51,253,0,62,35394
23025,52098,25768,26330,43.9,50542,193,262,222,44,152,52098
23027,38761,18993,19768,44.2,37673,131,102,163,0,99,38761
23029,32832,16144,16688,45.9,30322,137,1326,142,21,99,32832
23031,197861,96227,101634,43.0,190692,1060,705,2197,24,407,197861
24001,74645,38560,36085,41.0,66527,5767,116,644,34,426,74645
24003,538473,266299,272174,38.4,408521,82542,1384,18618,502,10407,538473
24005,807318,381691,425627,39.0,526372,210312,1956,40991,418,10567,807318
24009,88774,43769,45005,39.8,72392,12187,179,1114,0,704,88774
24011,32947,16070,16877,38.9,26504,4562,124,185,0,924,32947
24013,167249,82566,84683,41.1,155665,5535,284,2557,0,805,167249
24015,101109,50231,50878,39.0,90583,6440,229,1098,31,853,101109
24017,147107,71061,76046,37.2,75096,59877,1320,4832,35,1295,147107
24019,32570,15567,17003,42.9,22064,9057,63,328,9,562,32570
24021,234268,115246,119022,38.5,193183,20261,948,9129,136,4426,234268
24023,30079,14928,15151,42.9,29356,288,63,74,32,43,30079
24025,245396,120111,125285,39.5,199515,31332,534,6036,57,2952,245396
24027,288676,141445,147231,38.3,180357,51279,484,41579,139,5727,288676
24029,20184,9650,10534,45.3,16322,3077,127,160,0,208,20184
24031,974824,468237,506587,38.4,560968,167316,3282,136409,221,70481,974824
24033,865443,415176,450267,35.0,188843,555713,2526,35833,441,59409,865443
24035,47894,23696,24198,42.2,42659,3386,223,462,0,563,47894
24037,105528,52591,52937,36.0,83742,14375,318,2476,50,630,105528
24039,26402,14299,12103,36.9,14267,10784,43,273,6,211,26402
24041,37746,18031,19715,47.3,31050,5289,50,471,0,187,37746
24043,147882,75296,72586,39.8,125987,14534,410,2265,40,1020,147882
24045,98940,47225,51715,35.6,68575,23469,453,2602,0,1360,98940
24047,51398,25095,26303,48.1,42641,7409,108,617,0,30,51398
24510,620644,292035,328609,34.4,186860,395383,2099,14610,268,7822,620644
25001,216021,103047,112974,49.9,201956,4538,835,2409,8,2265,216021
25003,130866,62938,67928,44.6,121401,3479,296,1669,34,1055,130866
25005,548739,265784,282955,39.9,491011,20034,950,10516,41,13600,548739
25007,16581,8209,8372,45.4,15181,656,179,140,0,242,16581
25009,744961,358033,386928,40.4,605090,26816,1189,23986,115,71917,744961
25011,71489,34952,36537,44.3,67612,644,204,988,6,464,71489
25013,464072,223210,240862,38.8,360893,40649,1449,9369,11,41794,464072
25015,158850,74358,84492,36.2,142760,3901,214,7538,66,1154,158850
25017,1507558,733512,774046,38.5,1216987,69773,1927,142527,619,38998,1507558
25019,10194,5172,5022,38.8,9130,575,1,125,0,87,10194
25021,672078,321814,350264,40.6,553604,39518,908,59147,51,8459,672078
25023,495407,240954,254453,41.1,426413,41590,832,6429,89,10926,495407
25025,724502,349131,375371,31.6,406050,161767,2344,60415,329,51418,724502
25027,799277,393874,405403,39.2,692860,32407,1580,32096,207,21264,799277
26001,10943,5520,5423,55.3,10719,18,33,35,0,11,10943
26003,9531,5226,4305,47.5,8281,716,248,40,0,3,9531
26005,111589,55423,56166,39.0,104388,1383,715,765,0,2437,111589
26007,29602,14526,15076,45.8,28763,149,169,170,0,76,29602
26009,23634,11780,11854,48.0,22799,69,183,60,0,165,23634
26011,15952,8230,7722,46.7,15371,252,83,30,0,81,15952
26013,8808,4945,3863,43.3,6566,1030,711,150,2,30,8808
26015,59249,29609,29640,41.3,57566,271,196,269,21,260,59249
26017,107633,52732,54901,41.5,101486,1352,345,593,37,917,107633
26019,17554,8770,8784,46.4,16924,72,185,41,0,24,17554
26021,156759,76204,80555,40.8,122185,23943,634,2598,58,3573,156759
26023,44920,23352,21568,40.0,42375,1262,133,272,3,317,44920
26025,136063,66388,69675,39.2,112927,14885,747,2220,0,1204,136063
26027,52412,26068,26344,42.5,46460,2777,292,421,0,705,52412
26029,26057,12790,13267,45.3,24806,140,397,125,9,148,26057
26031,26195,13024,13171,47.1,24460,121,632,67,0,53,26195
26033,38919,21688,17231,39.1,28003,1960,6421,294,17,224,38919
26035,30924,15347,15577,45.5,29936,173,227,81,0,94,30924
26037,75274,37139,38135,38.5,70560,1532,180,943,30,471,75274
26039,14119,7186,6933,47.5,13742,147,19,74,11,27,14119
26041,37075,18339,18736,45.5,35049,97,773,37,72,47,37075
26043,26286,12979,13307,45.4,25471,75,49,147,0,56,26286
26045,107861,52475,55386,40.4,95245,6262,298,1928,11,914,107861
26047,32799,16183,16616,43.1,30480,198,909,179,64,104,32799
26049,425337,204946,220391,38.4,318400,86511,2279,4000,128,1920,425337
26051,25736,12927,12809,47.5,25087,140,88,101,2,126,25736
26053,16297,8633,7664,46.8,14924,739,345,49,12,29,16297
26055,87483,43223,44260,40.8,83097,1053,903,535,0,363,87483
26057,42340,22236,20104,38.5,38648,2188,139,171,20,419,42340
26059,46617,23172,23445,40.8,45442,239,254,215,0,70,46617
26061,36519,19825,16694,33.1,34390,253,260,1071,0,75,36519
26063,33001,16375,16626,46.8,32169,70,142,176,0,124,33001
26065,281323,136541,144782,31.3,215599,31215,1067,14737,123,5400,281323
26067,64149,34050,30099,36.5,58330,2496,291,185,5,867,64149
26069,25880,12850,13030,51.1,24991,96,257,175,0,43,25880
26071,11837,5886,5951,51.6,11490,143,18,28,1,7,11837
26073,70186,34005,36181,25.3,62536,1744,2182,1215,6,253,70186
26075,160257,81821,78436,39.5,140747,12940,961,1176,66,915,160257
26077,250704,122752,127952,34.0,206505,28158,1266,5615,94,2120,250704
26079,17231,8723,8508,43.2,16648,93,96,60,28,40,17231
26081,605244,296684,308560,34.3,496127,58312,2392,14098,236,16188,605244
26083,2168,1138,1030,51.8,2095,55,0,2,6,1,2168
26085,11543,5907,5636,50.0,10079,1049,98,13,0,34,11543
26087,88626,44726,43900,41.6,85044,966,260,312,8,815,88626
26089,21677,10671,11006,50.5,20268,89,729,82,0,146,21677
26091,99878,50320,49558,40.2,92544,2511,626,402,0,1665,99878
26093,181678,90763,90915,40.9,175601,772,509,1454,104,677,181678
26095,6590,3811,2779,43.5,5346,751,265,28,0,65,6590
26097,11144,5651,5493,49.1,8494,96,1762,50,0,85,11144
26099,841769,409517,432252,40.0,718496,72896,2554,26850,144,4722,841769
26101,24753,12852,11901,47.1,22856,754,502,51,0,116,24753
26103,67178,33955,33223,39.5,62916,1066,1181,412,2,89,67178
26105,28672,14173,14499,45.1,27367,176,269,145,0,159,28672
26107,42947,21654,21293,34.1,40189,1223,163,332,8,84,42947
26109,24041,12081,11960,46.2,22909,50,454,44,2,9,24041
26111,83744,41092,42652,40.3,78843,1073,326,1728,10,548,83744
26113,14945,7634,7311,41.9,14512,62,114,44,0,68,14945
26115,151944,75000,76944,40.3,143893,3078,516,861,19,873,151944
26117,63357,32729,30628,39.0,59771,1544,196,202,0,450,63357
26119,9709,4874,4835,52.3,9485,29,24,6,0,13,9709
26121,171755,85138,86617,38.5,138397,24007,1017,1073,55,1676,171755
26123,48517,24467,24050,40.7,45536,607,538,160,0,1004,48517
26125,1207097,585883,621214,40.2,936574,161550,3459,69016,308,8434,1207097
26127,26636,13397,13239,42.0,25213,139,243,75,0,536,26636
26129,21674,10768,10906,47.5,21065,62,62,66,0,25,21674
26131,6703,3494,3209,53.1,6519,45,61,17,0,5,6703
26133,23486,11727,11759,41.7,22773,149,98,45,5,13,23486
26135,8709,4412,4297,49.8,8492,6,89,6,0,5,8709
26137,24175,11868,12307,42.7,23384,35,81,131,0,109,24175
26139,264835,129905,134930,34.6,237054,3865,1114,7026,70,9903,264835
26141,13368,6721,6647,51.6,13037,38,86,50,15,36,13368
26143,24447,12173,12274,53.3,23741,89,152,103,14,77,24447
26145,200017,96799,103218,39.6,151291,37036,718,2193,122,2960,200017
26147,162978,80718,82260,41.3,153102,3937,361,847,13,1046,162978
26149,61314,30362,30952,38.6,57366,1644,191,357,0,462,61314
26151,43096,21351,21745,42.7,41806,197,157,44,4,302,43096
26153,8455,4187,4268,48.3,7412,28,670,14,0,10,8455
26155,70402,34768,35634,40.4,68415,403,385,224,39,161,70402
26157,55616,27930,27686,41.6,53538,581,214,162,3,300,55616
26159,76149,37710,38439,40.1,66916,3235,637,454,159,3279,76149
26161,346010,170767,175243,33.1,258770,42384,1017,27382,26,2935,346010
26163,1822469,875422,947047,37.2,959966,737559,6115,47832,483,30488,1822469
26165,32694,16274,16420,40.8,31550,159,191,146,3,25,32694
27001,16166,8223,7943,51.8,15432,76,262,72,0,34,16166
27003,331649,165788,165861,37.1,288614,13811,2163,13395,69,5236,331649
27005,32600,16361,16239,42.6,28787,115,2248,140,4,91,32600
27007,44652,22354,22298,33.5,33521,367,8526,357,173,104,44652
27009,38560,19270,19290,34.1,36567,825,184,370,0,16,38560
27011,5250,2571,2679,48.7,5162,17,11,2,0,4,5250
27013,63991,32050,31941,29.9,59295,1670,156,1246,2,334,63991
27015,25772,12744,13028,43.1,25219,75,28,165,17,158,25772
27017,35304,18385,16919,41.0,31634,565,1897,230,9,217,35304
27019,91355,45338,46017,36.3,84539,975,158,2279,32,1546,91355
27021,28519,14599,13920,47.0,24518,78,2974,109,70,25,28519
27023,12327,6061,6266,42.7,11631,46,79,52,97,221,12327
27025,53526,27708,25818,38.6,51174,636,274,447,2,239,53526
27027,58937,29097,29840,32.1,54597,898,895,733,47,540,58937
27029,8672,4434,4238,42.3,7533,51,766,48,0,9,8672
27031,5206,2657,2549,49.8,4569,28,348,39,18,21,5206
27033,11665,5726,5939,43.6,10807,63,30,271,0,309,11665
27035,62521,31154,31367,42.7,60496,456,580,251,0,82,62521
27037,399443,196203,203240,36.8,341770,19285,1694,17433,352,8678,399443
27039,20071,10048,10023,37.0,19493,112,23,110,0,175,20071
27041,36167,18090,18077,43.6,35379,210,139,99,3,10,36167
27043,14546,7282,7264,45.9,14104,75,59,28,0,155,14546
27045,20880,10398,10482,42.9,20509,35,45,73,0,84,20880
27047,31188,15573,15615,44.4,29760,239,110,291,0,451,31188
27049,46144,22951,23193,41.9,44083,502,477,308,0,198,46144
27051,6016,3014,3002,46.4,5885,30,9,18,0,32,6016
27053,1158039,569482,588557,35.9,878366,135342,9486,72135,438,24964,1158039
27055,19001,9360,9641,44.0,18564,39,40,35,6,30,19001
27057,20372,10330,10042,47.1,19303,46,445,65,7,71,20372
27059,38004,19131,18873,37.9,36594,231,234,252,6,58,38004
27061,45052,22709,22343,45.2,42149,140,1439,195,23,124,45052
27063,10273,5203,5070,44.4,9802,28,3,208,8,167,10273
27065,16255,8209,8046,42.1,15823,88,103,66,0,0,16255
27067,42150,21226,20924,39.8,39842,888,211,201,0,430,42150
27069,4547,2265,2282,47.8,4426,26,20,21,0,10,4547
27071,13293,6639,6654,46.2,12551,37,434,54,0,19,13293
27073,7240,3616,3624,49.1,7093,29,22,37,3,0,7240
27075,10849,5535,5314,48.4,10484,10,24,18,0,97,10849
27077,4039,2131,1908,48.5,3856,45,35,40,0,0,4039
27079,27744,13966,13778,40.2,26478,110,90,132,0,597,27744
27081,5876,2942,2934,46.5,5755,13,26,11,5,53,5876
27083,25714,12668,13046,34.4,23167,550,145,747,0,841,25714
27085,36527,18177,18350,39.1,34931,287,132,230,0,580,36527
27087,5442,2730,2712,37.2,2763,28,2138,66,0,36,5442
27089,9475,4820,4655,44.2,9291,39,43,19,0,19,9475
27091,20727,10213,10514,45.6,20202,72,14,92,0,152,20727
27093,23262,11774,11488,41.4,22725,57,62,77,12,149,23262
27095,26004,13041,12963,39.5,23725,121,1502,115,5,131,26004
27097,33173,16781,16392,40.6,32345,146,53,170,0,118,33173
27099,39115,19392,19723,38.6,36198,803,64,656,32,672,39115
27101,8690,4301,4389,47.0,8425,21,20,33,29,71,8690
27103,32689,16328,16361,33.3,30683,737,120,431,1,372,32689
27105,21349,10833,10516,36.7,17764,764,67,1038,15,1273,21349
27107,6796,3409,3387,45.1,6464,10,115,29,10,11,6796
27109,144507,70814,73693,36.3,125401,6829,268,7786,41,1009,144507
27111,57381,28702,28679,46.0,55222,456,297,332,4,356,57381
27113,13950,6855,7095,39.5,13118,192,166,99,29,69,13950
27115,29564,15810,13754,42.4,27169,628,836,139,10,184,29564
27117,9536,4662,4874,42.6,8944,62,144,32,12,194,9536
27119,31426,15889,15537,40.3,29303,243,462,236,39,627,31426
27121,10978,5567,5411,45.8,10781,53,48,35,0,0,10978
27123,510885,247785,263100,34.6,366877,55021,3159,60239,237,7765,510885
27125,4100,2084,2016,41.6,3945,17,46,0,0,16,4100
27127,16006,7999,8007,42.6,14319,91,771,526,0,70,16006
27129,15653,7944,7709,43.9,14964,78,137,84,0,292,15653
27131,64171,32741,31430,34.9,58228,2017,242,1219,49,1271,64171
27133,9620,4729,4891,41.4,9343,76,41,70,0,2,9620
27135,15665,8008,7657,40.3,14814,56,164,405,0,18,15665
27137,200150,100346,99804,40.8,186179,2841,4739,1880,28,614,200150
27139,130689,65044,65645,34.9,114098,3370,777,7445,17,1508,130689
27141,88558,45110,43448,34.3,83767,1583,409,1154,12,181,88558
27143,15189,7664,7525,40.6,14616,68,22,87,0,247,15189
27145,150307,75912,74395,33.4,138603,4627,530,2977,31,1486,150307
27147,36524,17974,18550,38.8,34067,779,40,310,0,576,36524
27149,9712,4804,4908,34.3,9102,44,201,72,0,105,9712
27151,9764,5024,4740,44.4,9450,133,45,13,0,68,9764
27153,24783,12641,12142,41.9,23629,70,77,133,0,586,24783
27155,3549,1800,1749,47.6,3324,3,164,0,0,21,3549
27157,21636,10820,10816,43.0,21203,97,28,85,0,67,21636
27159,13808,6787,7021,43.4,13337,57,195,32,0,27,13808
27161,19089,9158,9931,39.3,18013,381,76,112,0,60,19089
27163,238721,118190,120531,38.2,210330,8241,613,12389,58,1703,238721
27165,11177,5627,5550,40.4,10225,106,15,133,17,526,11177
27167,6584,3329,3255,42.8,6391,15,26,21,6,15,6584
27169,51481,25264,26217,33.1,48774,603,86,1215,0,169,51481
27171,124737,62838,61899,34.6,118062,1139,475,1122,0,1608,124737
27173,10357,5288,5069,42.7,9692,30,249,38,2,167,10357
28001,32391,16162,16229,40.4,12794,18739,66,116,0,511,32391
28003,37027,18074,18953,39.4,31735,4341,81,81,0,328,37027
28005,13139,6327,6812,44.3,7477,5576,33,5,0,38,13139
28007,19454,9210,10244,39.9,10891,8200,0,0,0,238,19454
28009,8725,4178,4547,40.2,5306,3133,67,0,0,101,8725
28011,34239,15953,18286,34.2,11235,22478,30,182,0,120,34239
28013,14903,7135,7768,39.3,10565,4193,3,0,34,1,14903
28015,10553,5237,5316,42.3,6825,3536,17,0,0,0,10553
28017,17458,8288,9170,38.4,9632,7294,15,62,0,160,17458
28019,8506,4076,4430,42.4,5731,2714,0,11,0,4,8506
28021,9681,4538,5143,31.7,1395,8177,11,98,0,0,9681
28023,16688,8028,8660,40.8,10694,5905,6,28,0,9,16688
28025,20633,9686,10947,38.8,8257,12123,31,36,0,90,20633
28027,26099,11950,14149,32.8,6064,19671,23,129,0,76,26099
28029,29324,14112,15212,36.4,13558,15065,13,99,0,430,29324
28031,19571,9527,10044,37.2,12248,7039,94,0,0,88,19571
28033,161536,78395,83141,35.1,118518,32671,708,1991,56,1902,161536
28035,75378,36007,39371,31.1,45440,27418,82,639,0,823,75378
28037,8055,3926,4129,41.4,5160,2787,31,44,0,0,8055
28039,22579,11607,10972,36.3,20038,1900,20,48,0,313,22579
28041,14352,8482,5870,36.3,10282,3466,86,11,0,102,14352
28043,21886,10282,11604,39.3,12315,9309,55,105,0,0,21886
28045,44044,21643,22401,40.5,38800,3368,46,498,0,581,44044
28047,188110,93344,94766,35.4,133316,42030,681,5522,14,1475,188110
28049,246335,115607,130728,33.0,70718,170031,270,1861,15,1780,246335
28051,19207,9050,10157,32.2,3069,16040,0,9,0,32,19207
28053,9399,4445,4954,35.1,2186,7130,14,0,0,12,9399
28055,1556,909,647,40.2,523,1033,0,0,0,0,1556
28057,23362,11388,11974,39.1,21619,1501,20,30,0,45,23362
28059,139430,68690,70740,37.0,102171,30122,362,2986,0,1389,139430
28061,17033,8097,8936,41.2,7976,8795,0,3,0,52,17033
28063,7743,3993,3750,38.6,1063,6674,0,6,0,0,7743
28065,12364,6054,6310,41.4,4793,7480,0,54,0,0,12364
28067,67868,33069,34799,36.8,46504,19124,86,356,0,1037,67868
28069,10391,5153,5238,37.4,3729,6193,344,8,0,0,10391
28071,47586,23434,24152,27.3,33938,11560,63,918,21,558,47586
28073,55580,26960,28620,33.1,43044,10700,134,660,0,396,55580
28075,80204,38646,41558,36.9,44540,33906,186,543,0,111,80204
28077,12832,6240,6592,40.1,8471,4259,7,7,0,54,12832
28079,23563,11750,11813,32.7,12300,9596,1360,0,0,122,23563
28081,83235,39628,43607,35.9,58188,22819,77,641,5,562,83235
28083,32196,15266,16930,32.5,8339,23049,163,242,12,264,32196
28085,34850,16622,18228,37.5,23931,10634,97,57,0,12,34850
28087,59584,28269,31315,36.2,32362,26040,70,328,0,245,59584
28089,95481,45756,49725,36.1,55027,36495,189,2062,37,1090,95481
28091,26810,12948,13862,37.8,17722,8806,3,17,0,62,26810
28093,37019,18281,18738,38.5,18414,17587,39,70,9,604,37019
28095,36912,17540,19372,39.2,25113,11428,35,33,15,24,36912
28097,10866,5106,5760,41.1,5720,5086,0,10,0,0,10866
28099,29682,14110,15572,35.3,18160,6191,4710,140,0,85,29682
28101,21687,10543,11144,37.8,13698,6684,1074,6,7,94,21687
28103,11511,5450,6061,36.5,3211,8274,8,0,0,0,11511
28105,47486,23596,23890,25.2,27899,17514,87,1336,0,279,47486
28107,34675,16602,18073,36.0,16964,17152,14,19,28,388,34675
28109,55886,27623,28263,39.2,47236,7106,351,321,13,235,55886
28111,12217,5965,6252,39.4,9462,2719,0,0,0,10,12217
28113,40300,19265,21035,37.1,18805,20836,134,233,0,138,40300
28115,29962,14741,15221,36.0,23956,4257,215,15,0,1223,29962
28117,25384,12471,12913,38.7,21419,3365,21,164,21,134,25384
28119,8171,3880,4291,38.5,2438,5700,6,13,0,0,8171
28121,142136,68720,73416,36.2,110726,27012,300,1751,7,914,142136
28123,28207,13810,14397,35.0,16298,10732,24,212,0,839,28207
28125,4835,2182,2653,38.2,1378,3442,6,0,0,0,4835
28127,27476,13334,14142,38.1,17386,9673,73,159,0,76,27476
28129,16425,7992,8433,39.2,12331,3924,0,16,0,60,16425
28131,17657,8833,8824,35.5,13901,3419,15,21,0,28,17657
28133,29230,15488,13742,33.4,7545,21330,36,99,16,145,29230
28135,15262,8300,6962,35.4,6787,8200,40,128,8,62,15262
28137,28580,13876,14704,36.2,19229,8795,0,107,4,275,28580
28139,22095,10807,11288,38.1,17843,3263,28,85,0,452,22095
28141,19573,9504,10069,42.5,18569,629,25,32,0,258,19573
28143,10716,5136,5580,32.2,2612,7828,0,67,0,96,10716
28145,27175,13272,13903,37.1,22420,3710,145,23,23,436,27175
28147,15405,7433,7972,36.8,8112,7124,0,0,0,67,15405
28149,48419,23086,25333,37.9,24565,22713,87,458,0,298,48419
28151,51010,23657,27353,35.2,13841,36184,97,259,0,431,51010
28153,20754,9971,10783,37.5,12458,8083,0,0,0,31,20754
28155,10162,4987,5175,40.5,7997,1985,12,33,0,27,10162
28157,9778,5255,4523,36.2,2870,6897,1,0,0,1,9778
28159,19160,9229,9931,39.4,9995,9076,6,14,0,47,19160
28161,12647,6128,6519,40.2,7651,4887,31,10,0,0,12647
28163,28220,15473,12747,35.4,11032,15924,80,76,0,683,28220
29001,25542,12134,13408,29.1,24094,492,83,404,80,39,25542
29003,17205,8430,8775,41.9,16729,110,60,37,0,57,17205
29005,5664,2832,2832,46.1,5539,62,9,2,0,17,5664
29007,25617,11694,13923,38.6,22984,1633,87,42,0,292,25617
29009,35680,17737,17943,41.8,32853,10,193,110,20,1404,35680
29011,12428,6173,6255,40.5,11794,13,109,81,0,104,12428
29013,17003,8389,8614,41.5,16364,71,67,17,0,148,17003
29015,19021,9512,9509,51.5,18473,35,117,126,0,82,19021
29017,12389,6188,6201,42.5,12158,73,0,40,0,0,12389
29019,163266,78988,84278,29.6,134707,14314,313,6173,111,2033,163266
29021,89162,44500,44662,36.6,79999,4021,313,703,164,1031,89162
29023,42792,20682,22110,40.6,38789,2343,132,271,0,357,42792
29025,9302,4633,4669,41.7,9022,65,9,22,0,13,9302
29027,44157,22731,21426,37.6,40661,1823,189,290,36,203,44157
29029,43731,21662,22069,48.7,42433,174,148,247,0,179,43731
29031,75690,36652,39038,36.3,67708,5342,164,925,82,329,75690
29033,9279,4551,4728,41.8,8950,169,6,36,0,28,9279
29035,6225,3033,3192,40.3,5984,42,30,0,0,6,6225
29037,99394,48595,50799,38.3,91569,3291,523,573,31,1284,99394
29039,13941,6967,6974,44.6,13515,29,45,55,1,43,13941
29041,7759,3833,3926,45.3,7497,193,1,9,0,1,7759
29043,77474,37812,39662,36.7,74303,467,319,408,0,457,77474
29045,7082,3547,3535,43.1,6915,45,18,17,0,18,7082
29047,222048,108572,113476,36.4,196357,11132,424,4660,479,2050,222048
29049,20687,10350,10337,40.6,19817,292,97,48,37,37,20687
29051,75813,38448,37365,37.8,63671,8582,284,836,41,1154,75813
29053,17542,9254,8288,37.6,15775,989,27,24,0,133,17542
29055,24753,12237,12516,40.2,24225,44,135,42,1,3,24753
29057,7811,3944,3867,46.3,7496,54,39,8,13,8,7811
29059,16825,8415,8410,41.7,16206,23,0,0,0,119,16825
29061,8341,4155,4186,40.3,8143,33,29,5,0,12,8341
29063,12878,8120,4758,40.2,11175,1126,54,48,1,67,12878
29065,15595,7806,7789,42.9,15034,52,160,125,7,17,15595
29067,13690,6788,6902,44.9,13475,9,62,0,0,53,13690
29069,31970,15451,16519,39.5,27972,3183,94,74,0,189,31970
29071,101440,50337,51103,39.4,98448,1270,266,535,22,123,101440
29073,15160,7445,7715,45.1,14841,47,83,47,0,18,15160
29075,6773,3291,3482,42.1,6657,38,24,12,8,9,6773
29077,275671,134221,141450,35.6,252247,7760,1235,4322,355,2214,275671
29079,10256,4891,5365,41.8,9956,92,55,32,0,5,10256
29081,8901,4458,4443,42.6,8706,63,11,14,6,26,8901
29083,22234,10844,11390,43.9,21459,267,60,54,58,62,22234
29085,9554,4666,4888,52.7,8824,36,92,27,9,6,9554
29087,4840,2402,2438,46.1,4709,34,41,19,0,4,4840
29089,10160,5047,5113,39.7,9342,537,37,16,0,34,10160
29091,40330,19477,20853,39.6,39042,136,378,93,0,24,40330
29093,10563,5251,5312,42.8,10191,121,23,9,0,28,10563
29095,672784,325081,347703,36.2,453515,160256,3192,11058,1477,22553,672784
29097,116493,56722,59771,35.1,106370,2263,1886,979,262,1422,116493
29099,218628,108663,109965,37.7,211034,1525,474,1177,164,756,218628
29101,52964,26826,26138,29.7,47784,2374,243,578,59,231,52964
29103,4111,2024,2087,43.9,3995,25,0,5,6,0,4111
29105,35507,17526,17981,39.1,34130,234,126,198,22,103,35507
29107,33278,16363,16915,40.3,31472,865,110,43,7,68,33278
29109,38559,19032,19527,39.3,36699,125,262,185,0,731,38559
29111,10203,5115,5088,38.7,9657,306,27,3,8,16,10203
29113,52637,26291,26346,35.6,49836,1110,197,249,0,271,52637
29115,12668,6059,6609,43.0,12292,75,18,27,2,26,12668
29117,15068,6749,8319,41.5,14404,385,50,18,12,3,15068
29119,22970,11526,11444,36.5,20317,211,589,230,133,624,22970
29121,15532,7562,7970,42.1,14798,420,78,109,0,0,15532
29123,12334,6085,6249,41.2,12003,21,8,87,8,82,12334
29125,9140,4568,4572,43.1,8874,76,44,42,0,49,9140
29127,28703,13809,14894,39.3,26349,1676,118,192,7,63,28703
29129,3763,1920,1843,43.7,3695,19,2,22,0,0,3763
29131,24822,12404,12418,40.3,24012,168,74,67,0,74,24822
29133,14231,7533,6698,39.8,10602,3405,42,5,0,3,14231
29135,15587,8169,7418,37.4,14198,709,113,23,3,91,15587
29137,8876,4364,4512,44.0,8425,307,47,20,0,2,8876
29139,12181,6067,6114,42.9,11712,96,14,39,0,34,12181
29141,20479,10118,10361,47.0,19810,144,222,12,0,29,20479
29143,18780,8969,9811,39.7,15379,2954,32,35,0,56,18780
29145,58314,28814,29500,39.1,52933,493,1448,838,522,606,58314
29147,23305,11818,11487,28.1,22175,579,54,195,3,67,23305
29149,10885,5425,5460,45.1,10465,16,129,31,0,28,10885
29151,13857,7221,6636,39.2,13704,109,1,9,2,0,13857
29153,9672,4929,4743,49.5,9435,14,23,0,0,18,9672
29155,18288,8688,9600,36.9,13008,5060,38,14,0,13,18288
29157,18986,9573,9413,39.5,18556,109,21,71,0,49,18986
29159,42044,20602,21442,37.3,37782,1249,87,264,70,1663,42044
29161,44825,23351,21474,34.0,40956,1012,292,1304,0,279,44825
29163,18574,10245,8329,39.8,16763,1213,125,27,0,46,18574
29165,89567,44061,45506,38.5,78483,5295,396,2350,324,1189,89567
29167,31035,15333,15702,38.1,29948,249,41,130,0,131,31035
29169,51620,28806,22814,26.6,39868,5941,591,1522,301,1345,51620
29171,4976,2487,2489,45.2,4878,25,9,21,0,0,4976
29173,10198,5090,5108,44.2,9897,39,53,8,0,38,10198
29175,25388,13394,11994,37.9,23061,1644,62,138,0,111,25388
29177,23422,11668,11754,40.0,22528,311,54,107,4,42,23422
29179,6682,3407,3275,44.8,6460,59,45,3,0,15,6682
29181,14070,6891,7179,41.9,13635,64,83,24,0,19,14070
29183,360695,177047,183648,37.0,327981,16045,487,7997,95,1953,360695
29185,9693,4852,4841,48.6,9299,64,28,10,0,61,9693
29186,18066,9101,8965,42.6,17647,137,6,0,194,18,18066
29187,65246,35056,30190,38.7,61082,3061,211,126,0,129,65246
29189,999147,472886,526261,39.8,705720,231255,1386,34256,316,5633,999147
29195,23232,11704,11528,38.0,20139,1341,38,101,124,1019,23232
29197,4397,2127,2270,41.4,4317,41,15,6,9,0,4397
29199,4843,2390,2453,39.4,4792,7,0,0,0,0,4843
29201,39192,18910,20282,38.9,33804,4464,87,172,12,86,39192
29203,8407,4164,4243,44.2,8112,49,106,0,0,0,8407
29205,6328,3120,3208,43.4,6199,78,23,0,3,0,6328
29207,29902,14526,15376,41.4,29062,432,182,12,0,59,29902
29209,31968,15684,16284,49.7,27935,38,316,94,0,179,31968
29211,6667,3395,3272,40.2,6391,22,15,12,0,121,6667
29213,51596,25177,26419,41.1,48610,139,150,270,0,771,51596
29215,25840,13211,12629,41.9,24120,864,158,32,0,95,25840
29217,20958,10124,10834,40.3,20255,127,76,132,5,38,20958
29219,32440,16264,16176,39.7,30594,540,26,72,5,462,32440
29221,25120,12775,12345,40.1,24087,524,120,58,12,62,25120
29223,13444,6715,6729,45.9,13046,34,106,11,4,17,13444
29225,36183,18377,17806,37.6,34824,420,204,59,0,95,36183
29227,2146,1039,1107,47.5,2123,0,0,0,0,0,2146
29229,18732,9160,9572,40.6,18092,118,71,57,0,167,18732
29510,318527,153691,164836,34.0,141594,155916,728,8461,75,2918,318527
30001,9228,4627,4601,44.0,8816,20,106,71,16,12,9228
30003,12872,6440,6432,30.1,4236,1,8067,94,0,76,12872
30005,6514,3275,3239,35.0,3187,0,3196,5,25,24,6514
30007,5575,2828,2747,45.6,5325,36,8,26,0,1,5575
30009,10057,5130,4927,48.0,9748,6,113,72,10,78,10057
30011,1276,623,653,51.5,1255,0,17,0,0,2,1276
30013,81248,40320,40928,38.7,72665,951,3519,467,2,424,81248
30015,5811,2876,2935,41.5,4469,0,1202,25,0,6,5811
30017,11706,5793,5913,41.7,11217,28,164,50,23,56,11706
30019,1734,881,853,51.7,1629,0,96,9,0,0,1734
30021,9022,4685,4337,42.1,8696,17,177,12,11,7,9022
30023,9277,4858,4419,46.2,8622,59,202,20,87,82,9277
30025,3051,1506,1545,40.8,2989,0,5,0,0,0,3051
30027,11507,5808,5699,48.1,11122,11,188,4,0,47,11507
30029,90967,45489,45478,41.2,87017,209,1416,508,27,218,90967
30031,90339,46716,43623,32.4,85949,344,926,920,53,418,90339
30033,1100,547,553,48.0,1076,0,12,0,0,0,1100
30035,13422,6530,6892,31.4,4244,1,8696,50,13,83,13422
30037,769,378,391,50.2,766,0,0,0,0,1,769
30039,3083,1572,1511,51.8,3011,4,17,10,0,0,3083
30041,16157,8217,7940,35.2,11917,33,3511,47,32,55,16157
30043,11360,5847,5513,46.8,10864,73,90,51,0,37,11360
30045,2052,970,1082,51.3,2026,0,5,0,0,2,2052
30047,28794,14106,14688,41.0,20215,60,6644,66,0,30,28794
30049,63432,31438,31994,40.7,59516,266,1471,292,23,231,63432
30051,2326,1071,1255,47.6,2246,8,33,0,14,15,2326
30053,19594,9941,9653,49.2,18831,54,383,95,0,16,19594
30055,1808,922,886,47.1,1764,0,2,0,0,0,1808
30057,7688,3975,3713,50.0,7453,15,22,41,12,31,7688
30059,1900,971,929,46.9,1876,0,5,5,0,6,1900
30061,4203,2194,2009,49.6,3994,95,90,11,0,4,4203
30063,109402,55118,54284,34.3,101761,453,2811,1205,147,343,109402
30065,4597,2345,2252,48.2,4411,12,24,0,0,22,4597
30067,15655,7753,7902,45.9,15140,24,86,6,2,15,15655
30069,566,290,276,47.6,536,21,0,0,0,0,566
30071,4203,2091,2112,48.4,3636,0,298,1,0,35,4203
30073,6147,2925,3222,42.9,5105,30,882,14,0,26,6147
30075,1639,850,789,47.4,1577,0,14,0,0,0,1639
30077,7067,4386,2681,45.4,6534,27,253,38,16,16,7067
30079,1193,623,570,56.3,1143,0,33,0,1,0,1193
30081,40311,19987,20324,46.3,38841,111,382,207,0,84,40311
30083,9961,5185,4776,40.5,9529,43,175,0,0,61,9961
30085,10477,5134,5343,30.9,3836,5,5626,17,0,40,10477
30087,9261,4564,4697,37.3,5720,47,3086,56,0,93,9261
30089,11421,5834,5587,49.9,10484,26,639,30,0,43,11421
30091,3447,1742,1705,48.2,3286,6,43,1,0,0,3447
30093,34164,17221,16943,41.7,32503,71,544,201,0,163,34164
30095,9096,4690,4406,46.0,8796,15,57,14,19,57,9096
30097,3661,1947,1714,43.1,3565,0,0,20,0,0,3661
30099,6082,3005,3077,45.6,5833,5,113,11,0,41,6082
30101,5210,2894,2316,42.8,4733,17,261,1,14,66,5210
30103,698,380,318,51.9,617,0,3,10,0,39,698
30105,7423,3694,3729,45.8,6464,9,804,8,3,12,7423
30107,2142,1040,1102,48.5,2096,0,9,0,0,3,2142
30109,899,470,429,50.2,890,9,0,0,0,0,899
30111,148191,72439,75752,38.5,134147,923,5872,1243,124,2610,148191
31001,31299,15576,15723,37.8,29659,204,126,412,6,410,31299
31003,6655,3306,3349,46.5,6564,10,5,7,0,0,6655
31005,490,254,236,37.4,487,0,0,0,0,0,490
31007,778,370,408,45.2,748,14,0,2,0,5,778
31009,584,294,290,41.3,568,0,0,0,0,0,584
31011,5473,2734,2739,45.7,5443,1,0,8,5,0,5473
31013,11345,5561,5784,40.5,10253,11,441,34,0,346,11345
31015,2025,1018,1007,50.8,1992,20,3,0,0,3,2025
31017,3183,1561,1622,46.7,3131,4,0,6,0,0,3183
31019,46330,22942,23388,32.3,43319,332,74,509,0,1288,46330
31021,6829,3333,3496,47.2,6582,32,112,10,0,16,6829
31023,8345,4190,4155,44.4,8140,76,21,5,0,92,8345
31025,25214,12702,12512,40.9,24482,163,37,102,0,130,25214
31027,8807,4462,4345,44.5,8714,12,19,15,0,0,8807
31029,3964,1938,2026,43.7,3883,1,0,0,0,19,3964
31031,5722,2910,2812,47.1,5349,13,144,75,0,0,5722
31033,10038,4983,5055,40.3,9698,28,63,191,0,6,10038
31035,6497,3245,3252,43.8,6343,14,66,0,27,16,6497
31037,10453,5368,5085,34.4,9465,138,85,16,8,300,10453
31039,9140,4537,4603,43.4,8749,43,6,13,0,217,9140
31041,10904,5384,5520,44.7,10650,15,9,0,0,59,10904
31043,20869,10404,10465,32.8,14769,744,499,677,0,3894,20869
31045,9176,4472,4704,34.9,8335,197,409,133,0,0,9176
31047,24267,12246,12021,36.5,19722,789,133,118,0,3179,24267
31049,1962,977,985,49.1,1936,7,2,0,0,0,1962
31051,5982,2953,3029,41.0,5810,19,33,0,0,70,5982
31053,36590,17776,18814,40.2,35222,131,234,183,51,271,36590
31055,518271,254707,263564,33.6,405196,58444,3512,13566,344,22053,518271
31057,1996,989,1007,47.4,1981,3,0,5,0,4,1996
31059,5867,2828,3039,45.9,5692,57,29,9,0,46,5867
31061,3196,1607,1589,48.8,3141,7,10,5,0,3,3196
31063,2693,1361,1332,44.8,2657,7,6,0,0,4,2693
31065,4922,2402,2520,47.1,4803,7,61,4,0,25,4922
31067,22209,10859,11350,43.6,21624,41,37,84,12,45,22209
31069,2011,1042,969,51.4,1960,0,0,13,2,0,2011
31071,2106,1030,1076,49.1,2078,13,0,0,0,0,2106
31073,2020,997,1023,45.4,1937,12,22,0,0,30,2020
31075,608,317,291,47.3,607,0,0,0,0,0,608
31077,2515,1264,1251,46.1,2495,14,3,0,0,0,2515
31079,58681,29298,29383,35.6,53936,1191,486,592,0,1766,58681
31081,9096,4510,4586,42.9,8950,16,15,7,0,15,9096
31083,3419,1750,1669,49.9,3364,3,12,0,0,12,3419
31085,1037,555,482,45.5,1019,2,0,6,0,3,1037
31087,2898,1471,1427,49.1,2848,3,12,7,0,8,2898
31089,10418,5144,5274,45.9,10097,2,78,19,0,187,10418
31091,689,380,309,47.8,680,0,2,5,0,1,689
31093,6294,3205,3089,43.2,6181,36,38,9,0,14,6294
31095,7572,3741,3831,47.0,7437,5,32,47,0,7,7572
31097,5188,2973,2215,43.7,4663,279,17,51,0,80,5188
31099,6514,3186,3328,41.9,6404,4,8,43,0,17,6514
31101,8284,4187,4097,48.2,7948,17,43,13,33,77,8284
31103,742,368,374,53.7,731,0,0,6,0,0,742
31105,3789,1947,1842,46.8,3634,30,57,3,0,42,3789
31107,8648,4227,4421,46.6,7699,42,712,26,0,43,8648
31109,286425,143500,142925,32.6,253964,10535,1887,10442,206,2332,286425
31111,36212,17782,18430,38.7,34094,242,59,189,2,653,36212
31113,724,334,390,50.5,724,0,0,0,0,0,724
31115,534,304,230,47.5,495,0,4,0,0,18,534
31117,348,187,161,49.0,348,0,0,0,0,0,348
31119,34766,17112,17654,37.2,32498,442,595,205,49,558,34766
31121,7779,3825,3954,43.3,7562,41,42,10,0,21,7779
31123,4993,2541,2452,43.1,4819,4,27,21,0,32,4993
31125,3730,1871,1859,44.9,3684,4,3,0,0,27,3730
31127,7224,3530,3694,41.5,6981,60,50,33,0,44,7224
31129,4490,2192,2298,49.3,4420,18,0,10,0,0,4490
31131,15729,7734,7995,42.7,15288,23,40,56,0,52,15729
31133,2753,1379,1374,49.3,2730,0,5,0,0,0,2753
31135,2947,1510,1437,45.1,2925,0,0,0,0,5,2947
31137,9184,4527,4657,43.9,8995,11,27,32,11,4,9184
31139,7231,3688,3543,41.9,7099,6,26,17,0,14,7231
31141,32195,16058,16137,38.7,30786,90,40,92,0,551,32195
31143,5371,2671,2700,45.1,5216,8,8,8,0,61,5371
31145,11013,5404,5609,42.4,10692,92,64,44,0,37,11013
31147,8355,4032,4323,47.7,7911,14,87,24,0,11,8355
31149,1540,726,814,49.4,1496,12,0,5,0,6,1540
31151,14278,7311,6967,36.0,13340,190,48,95,0,312,14278
31153,159413,79300,80113,33.0,142252,6487,677,3209,221,1892,159413
31155,20696,10517,10179,41.9,20214,57,69,51,0,108,20696
31157,36835,17734,19101,38.7,34089,235,511,253,20,1012,36835
31159,16729,8581,8148,38.3,16213,82,13,132,0,147,16729
31161,5432,2608,2824,46.6,4680,9,395,29,0,4,5432
31163,3133,1537,1596,48.6,3094,30,7,2,0,0,3133
31165,1262,614,648,47.5,1224,0,0,0,0,10,1262
31167,6139,3086,3053,39.0,5854,23,26,57,0,36,6139
31169,5195,2561,2634,48.8,5097,6,5,2,0,3,5195
31171,831,389,442,38.9,789,6,8,14,0,0,831
31173,6926,3448,3478,28.6,2765,33,3919,28,8,12,6926
31175,4322,2122,2200,47.3,4240,1,11,0,0,25,4322
31177,20201,10067,10134,41.0,19718,100,35,46,32,40,20201
31179,9542,4793,4749,29.4,9123,137,0,45,0,122,9542
31181,3773,1779,1994,47.5,3659,4,0,67,6,4,3773
31183,725,371,354,47.3,685,0,0,0,0,36,725
31185,13727,6577,7150,42.2,13000,86,60,48,32,302,13727
32001,24779,12354,12425,39.2,20441,447,1249,785,60,1019,24779
32003,1954773,984265,970508,35.5,1337840,203875,11640,169472,13250,137234,1954773
32005,47056,23565,23491,47.3,42561,190,1009,501,87,1075,47056
32007,49133,25637,23496,33.4,43614,501,2658,500,78,992,49133
32009,916,506,410,51.8,826,7,28,0,0,43,916
32011,1809,942,867,38.5,1672,11,70,0,6,39,1809
32013,16511,8608,7903,36.6,14539,51,908,126,6,573,16511
32015,5751,3057,2694,35.4,5285,8,232,18,0,54,5751
32017,5282,2726,2556,35.9,4787,159,266,13,3,14,5282
32019,51797,26094,25703,40.6,45453,498,1454,793,199,1835,51797
32021,4718,2382,2336,50.4,3617,85,628,84,2,125,4718
32023,43801,22208,21593,48.8,39416,1027,920,621,122,954,43801
32027,6707,4371,2336,39.9,5732,282,193,30,5,237,6707
32029,4010,2023,1987,52.8,3783,15,54,19,10,5,4010
32031,422010,212882,209128,37.0,345079,10372,6765,21573,2523,21455,422010
32033,9967,5340,4627,42.0,8577,242,766,39,16,125,9967
32510,55184,28536,26648,41.6,46852,535,1221,1671,105,3523,55184
33001,60206,29442,30764,44.5,58087,396,81,680,0,121,60206
33003,47761,23783,23978,48.2,46531,63,190,250,0,69,47761
33005,77106,37537,39569,41.1,74213,450,242,963,0,261,77106
33007,32872,16704,16168,46.6,31875,195,128,123,0,92,32872
33009,88985,43977,45008,41.2,83441,859,275,2588,6,264,88985
33011,401101,198575,202526,39.2,366151,8321,635,13390,120,5522,401101
33013,146742,72352,74390,41.5,140170,1517,248,2249,26,345,146742
33015,295872,146191,149681,42.3,283117,2284,335,5134,37,1110,295872
33017,123295,60043,63252,36.7,115715,1098,263,3054,0,719,123295
33019,43534,21444,22090,44.2,42140,156,73,253,14,188,43534
34001,274402,133243,141159,40.1,180960,44727,867,20948,142,18154,274402
34003,906781,437214,469567,41.2,666754,50694,1507,132801,107,36516,906781
34005,449117,220812,228305,40.3,333460,72612,528,19759,122,9004,449117
34007,513660,247930,265730,37.7,332006,97391,2205,26329,133,39953,513660
34009,96987,47267,49720,47.3,88060,4685,523,944,7,1476,96987
34011,156864,80801,76063,36.8,100432,31654,1530,2060,6,15365,156864
34013,783840,375925,407915,36.3,339640,317719,2084,36585,534,60371,783840
34015,288187,139890,148297,38.7,239402,28656,460,7763,61,5265,288187
34017,636194,314989,321205,34.2,355293,82956,2522,85911,311,90564,636194
34019,127996,63852,64144,43.4,116882,3366,90,4101,228,1820,127996
34021,366442,179071,187371,37.8,232853,73852,1030,32978,49,18709,366442
34023,811064,398362,412702,37.2,509495,76560,1440,176635,254,29248,811064
34025,629263,306128,323135,41.4,525127,46100,1751,31963,30,10857,629263
34027,493472,241638,251834,41.2,407897,15367,923,44934,79,15373,493472
34029,575961,276133,299828,42.7,526812,17700,869,9873,70,11172,575961
34031,500168,242949,257219,36.2,329232,62737,1420,25657,68,66561,500168
34033,66007,32058,33949,40.9,52871,9535,155,649,3,1594,66007
34035,323650,157862,165788,40.2,229327,28280,492,46139,45,12887,323650
34037,148962,74120,74842,41.8,139363,2950,306,2649,11,1612,148962
34039,536383,260183,276200,37.9,317464,115746,862,24696,332,68251,536383
34041,108488,52762,55726,41.4,97693,4020,138,2641,0,2277,108488
35001,661924,324280,337644,36.0,462080,18731,30332,14963,606,109996,661924
35003,3686,2022,1664,57.6,3376,0,136,0,0,107,3686
35005,65343,32323,33020,34.8,53373,1036,751,470,31,6699,65343
35006,27293,13764,13529,37.2,12865,116,11431,52,34,2034,27293
35007,13614,6912,6702,46.3,10981,83,475,58,0,1625,13614
35009,48101,24229,23872,31.6,33410,3081,800,641,49,8767,48101
35011,2069,973,1096,47.0,1624,2,0,0,0,395,2069
35013,208794,102390,106404,32.4,186963,3340,2345,2378,13,10205,208794
35015,53693,26763,26930,37.0,46503,287,772,16,84,3776,53693
35017,29602,14575,15027,45.8,22602,129,748,139,0,5331,29602
35019,4655,2467,2188,40.1,3293,76,112,1,9,1073,4655
35021,612,320,292,53.8,523,0,8,4,0,68,612
35023,4903,2436,2467,40.2,4004,67,22,0,0,751,4903
35025,64670,33134,31536,31.6,55487,2520,578,181,0,4331,64670
35027,20440,10056,10384,49.2,17297,82,317,10,8,1885,20440
35028,18008,9022,8986,44.0,15932,78,60,1021,18,360,18008
35029,25162,12473,12689,38.4,22815,222,241,52,19,1332,25162
35031,71888,35099,36789,30.3,12146,433,53553,506,38,2988,71888
35033,4830,2467,2363,46.3,3672,2,118,0,0,959,4830
35035,64176,32503,31673,36.1,50689,2487,4413,908,53,3635,64176
35037,8956,4323,4633,45.5,7713,97,216,47,8,671,8956
35039,40201,19781,20420,39.1,28827,166,5899,177,7,4546,40201
35041,19840,10091,9749,29.9,15281,470,267,193,0,3372,19840
35043,131302,64327,66975,38.1,95072,3879,16678,1750,100,10020,131302
35045,128600,63830,64770,32.8,69170,860,47668,480,153,6505,128600
35047,29225,14476,14749,41.4,22283,405,550,81,37,5087,29225
35049,144209,70059,74150,43.0,123374,1265,4119,1696,22,10129,144209
35051,11956,5963,5993,53.8,10893,79,181,0,0,572,11956
35053,17843,9140,8703,35.8,14155,204,1988,175,25,1019,17843
35055,32775,16132,16643,45.4,18757,158,1945,254,4,10225,32775
35057,16285,8348,7937,40.8,14584,82,254,71,0,962,16285
35059,4460,2494,1966,40.5,3305,206,94,6,0,671,4460
35061,76172,38538,37634,37.4,49592,991,2714,525,26,20093,76172
36001,304511,147190,157321,38.2,237873,38343,593,14654,95,5366,304511
36003,48837,24748,24089,37.8,46960,627,155,529,19,160,48837
36005,1386364,650728,735636,32.7,312055,481739,7196,49489,308,488156,1386364
36007,199928,98022,101906,40.2,176883,9327,658,7008,30,1709,199928
36009,80166,39681,40485,40.8,74589,1111,2206,597,21,289,80166
36011,79996,40809,39187,41.6,74104,3478,261,474,3,432,79996
36013,134599,66287,68312,40.6,125574,3161,699,894,119,1868,134599
36015,88779,44313,44466,40.9,79138,5446,231,984,0,282,88779
36017,50490,25179,25311,42.9,48781,284,32,150,0,240,50490
36019,82054,42238,39816,39.1,75715,3435,283,853,54,634,82054
36021,62881,31671,31210,45.3,57054,2823,103,1011,0,410,62881
36023,49453,24142,25311,35.8,46737,768,151,498,42,443,49453
36025,47851,24042,23809,45.3,45527,763,112,407,3,460,47851
36027,297291,148019,149272,40.2,235943,29134,684,11167,51,13229,297291
36029,919542,443476,476066,40.3,736093,122004,4793,24746,143,14411,919542
36031,39309,20545,18764,44.6,36708,1185,53,167,11,653,39309
36033,51698,28388,23310,39.3,43360,3333,2798,552,30,689,51698
36035,55358,27467,27891,41.7,52865,868,105,403,0,330,55358
36037,59992,29825,30167,41.6,55716,1603,558,339,11,593,59992
36039,49122,25761,23361,44.0,44467,2919,60,411,0,391,49122
36041,4835,2447,2388,51.0,4692,39,0,10,0,13,4835
36043,64475,31478,32997,42.3,62338,610,161,332,51,333,64475
36045,117011,60036,56975,32.3,102535,5629,436,1737,351,2201,117011
36047,2512740,1186163,1326577,34.1,1119881,859622,8247,266557,1372,209788,2512740
36049,27062,13642,13420,40.3,26434,248,56,59,0,64,27062
36051,65215,32534,32681,39.7,61181,1582,160,749,19,430,65215
36053,72977,35964,37013,39.3,69358,1353,501,543,3,229,72977
36055,744746,359365,385381,38.4,570868,112370,1998,24542,238,17788,744746
36057,50025,24411,25614,40.9,45715,847,141,362,18,1906,50025
36059,1338712,647788,690924,41.2,973573,148771,2310,103765,81,81435,1338712
36061,1596735,751244,845491,36.4,909145,247743,5012,178673,804,192325,1596735
36063,215869,104759,111110,41.8,191753,15345,1985,2268,99,830,215869
36065,234336,116849,117487,40.9,203928,13212,459,7049,89,3864,234336
36067,466179,224626,241553,38.7,380600,50499,3557,14702,50,4564,466179
36069,107728,52670,55058,42.3,101122,2416,211,1244,0,674,107728
36071,372951,186531,186420,36.7,288487,37428,1175,9453,20,25785,372951
36073,42995,21218,21777,40.9,38500,2640,268,230,2,571,42995
36075,122055,60835,61220,38.6,117371,1071,355,756,5,825,122055
36077,62147,29970,32177,40.4,58869,1191,57,683,0,394,62147
36079,99702,49693,50009,41.7,89418,2064,270,2006,0,3826,99702
36081,2235008,1082322,1152686,37.3,950264,421540,9475,522638,1356,260286,2235008
36083,159464,78731,80733,39.6,140475,9074,210,3449,39,1351,159464
36085,468374,226977,241397,38.6,354836,48635,813,36292,26,18866,468374
36087,312011,152950,159061,36.8,226906,38105,670,20118,74,21403,312011
36089,112060,56988,55072,37.2,104807,3036,561,1141,82,834,112060
36091,219832,108002,111830,40.8,207694,3197,320,3841,48,793,219832
36093,154466,74674,79792,40.0,124632,14996,604,5678,123,3709,154466
36095,32617,16288,16329,42.4,31271,443,98,224,0,222,32617
36097,18472,9217,9255,44.3,17927,212,31,40,0,37,18472
36099,35306,18470,16836,41.2,32695,1686,144,201,0,82,35306
36101,98992,49065,49927,41.3,94265,1754,238,1337,0,417,98992
36103,1492360,734110,758250,39.8,1227708,110478,3486,52009,297,71037,1492360
36105,77340,39626,37714,41.8,62970,6668,337,1197,0,3299,77340
36107,51067,25177,25890,42.8,49443,347,143,302,0,160,51067
36109,101570,50068,51502,29.8,84172,3969,310,9391,19,1034,101570
36111,182516,90745,91771,42.1,160024,10438,424,3131,24,2872,182516
36113,65700,31929,33771,44.2,63459,648,292,518,65,243,65700
36115,63108,32803,30305,42.2,59603,1939,75,307,35,393,63108
36117,93476,46355,47121,41.8,87495,3467,284,587,0,576,93476
36119,950227,457439,492788,40.1,642623,136936,1741,51797,144,90239,950227
36121,42092,22842,19250,40.7,38432,2440,121,183,0,516,42092
36123,25351,12343,13008,40.4,24657,216,33,105,3,61,25351
37001,151170,71944,79226,38.5,105718,27279,374,1910,154,11723,151170
37003,37014,18575,18439,41.1,32871,2021,87,314,9,1164,37014
37005,11069,5558,5511,46.0,10276,128,36,32,10,425,11069
37007,26699,13918,12781,39.5,12687,12968,174,301,0,318,26699
37009,27099,13250,13849,45.4,25561,109,136,69,0,867,27099
37011,17815,9733,8082,42.2,15503,705,135,133,57,321,17815
37013,47542,22790,24752,44.0,32475,12440,45,88,1,1869,47542
37015,21035,10415,10620,43.1,7456,13247,61,112,4,74,21035
37017,34922,16633,18289,41.0,20176,11918,788,46,0,1055,34922
37019,107925,52565,55360,47.6,91265,12134,311,482,97,1208,107925
37021,239000,114864,124136,40.7,211727,15326,951,2484,194,2627,239000
37023,90821,45525,45296,41.4,77635,6068,247,3023,28,2072,90821
37025,178396,87018,91378,36.7,139602,27464,724,3624,14,3293,178396
37027,82493,40473,42020,41.2,74276,3928,289,477,74,2295,82493
37029,9965,4994,4971,40.1,8191,1305,133,186,0,78,9965
37031,66415,32646,33769,45.7,58957,4341,364,624,5,985,66415
37033,23615,12049,11566,43.6,14783,7926,132,21,0,296,23615
37035,154201,75649,78552,39.7,127427,13112,571,5305,40,4700,154201
37037,63896,30876,33020,44.1,50154,8586,215,809,10,3209,63896
37039,27304,13245,14059,48.3,25427,267,507,155,4,353,27304
37041,14825,7088,7737,44.7,9323,5064,124,109,0,172,14825
37043,10575,5155,5420,49.6,10169,82,38,21,0,186,10575
37045,97890,47040,50850,40.5,74895,20476,188,860,0,480,97890
37047,57612,28527,29085,40.4,35334,17588,1786,73,12,1895,57612
37049,102904,51438,51466,36.5,72226,22465,395,2120,192,2546,102904
37051,319329,154714,164615,30.9,165619,114520,3282,7323,1007,9216,319329
37053,23677,11842,11835,41.0,21443,1485,48,100,0,81,23677
37055,34019,17001,17018,43.5,31611,1416,187,29,0,539,34019
37057,162628,79756,82872,40.4,139671,14912,738,2187,22,3242,162628
37059,41183,20151,21032,42.6,36119,2811,146,169,33,1552,41183
37061,58510,28752,29758,37.4,33479,14888,56,196,0,9014,58510
37063,269283,128496,140787,33.4,131635,100777,1086,12003,94,16262,269283
37065,56253,26163,30090,40.0,21988,32199,261,66,13,1116,56253
37067,351368,166896,184472,37.3,229686,92066,767,6641,31,16315,351368
37069,60470,30082,30388,39.8,40547,15602,397,287,7,2341,60470
37071,206291,99900,106391,38.8,160843,31084,965,2665,21,7395,206291
37073,12069,5989,6080,42.4,7666,4129,21,39,0,87,12069
37075,8766,4316,4450,42.7,7864,48,505,84,14,83,8766
37077,59666,31734,27932,39.9,36140,19455,258,380,14,2372,59666
37079,21386,11459,9927,38.1,10624,7906,131,55,0,1988,21386
37081,489576,233213,256363,36.4,282773,160319,2486,20137,88,14270,489576
37083,54693,26212,28481,41.9,21959,28074,1711,340,8,539,54693
37085,115559,56719,58840,33.5,80169,23909,1023,1098,26,4782,115559
37087,58915,28473,30442,45.7,56326,554,317,223,8,531,58915
37089,106577,51488,55089,45.3,96600,3595,542,1139,0,2751,106577
37091,24525,12118,12407,40.9,8814,14681,346,157,1,143,24525
37093,47368,23117,24251,30.8,22299,16220,4097,601,108,1824,47368
37095,5810,3172,2638,40.0,3453,2009,33,7,0,303,5810
37097,159614,78719,80895,39.0,131158,19306,548,2978,15,3115,159614
37099,39985,19659,20326,36.6,33714,814,3681,276,52,664,39985
37101,169122,83393,85729,36.6,132547,25445,520,834,0,5817,169122
37103,10144,5055,5089,44.4,6321,3261,40,12,67,242,10144
37105,57876,28457,29419,37.6,38505,11469,304,622,23,5853,57876
37107,59372,28334,31038,41.0,31686,24123,123,254,7,2134,59372
37109,78052,38527,39525,40.8,70721,4263,204,443,0,1157,78052
37111,44926,22485,22441,41.8,41380,1638,132,417,11,655,44926
37113,33815,16427,17388,48.4,31663,308,102,241,12,1223,33815
37115,20727,10326,10401,43.6,19919,269,67,95,0,169,20727
37117,24298,11364,12934,44.1,12910,10497,84,44,5,443,24298
37119,926873,448166,478707,34.0,537507,282309,3670,43659,672,36505,926873
37121,15539,7627,7912,45.3,15122,127,38,41,10,111,15539
37123,27741,13397,14344,39.7,21052,5242,135,446,0,646,27741
37125,88314,42228,46086,45.1,72722,11639,587,777,7,1088,88314
37127,95545,46022,49523,40.3,53751,35412,497,775,0,2893,95545
37129,203276,98438,104838,37.4,163535,29755,754,2742,89,2804,203276
37131,21959,10589,11370,45.4,8775,12556,24,16,16,54,21959
37133,176461,95036,81425,25.8,131513,29023,1180,3071,389,5408,176461
37135,133958,64018,69940,33.3,102023,15699,425,9089,19,3226,133958
37137,13145,6697,6448,48.0,10114,2537,66,42,0,42,13145
37139,40551,19752,20799,36.3,23357,15656,27,470,7,558,40551
37141,52447,26307,26140,41.2,40013,9637,202,237,8,1694,52447
37143,13414,6276,7138,46.3,9589,3471,0,2,0,68,13414
37145,39322,19161,20161,41.5,27065,10801,269,135,0,716,39322
37147,167951,79231,88720,30.9,100209,56980,432,2638,0,3859,167951
37149,20386,9839,10547,49.5,18768,1038,11,76,0,345,20386
37151,141568,69758,71810,39.6,124563,7858,519,1403,4,5039,141568
37153,46608,22811,23797,38.9,28978,14235,1263,265,0,1141,46608
37155,133920,65068,68852,34.3,41535,32256,50448,1072,86,5150,133920
37157,93264,45037,48227,42.2,70534,17471,273,423,46,2699,93264
37159,138189,68153,70036,39.1,106969,22624,711,1375,44,4302,138189
37161,67446,32499,34947,42.1,58319,6782,262,355,0,833,67446
37163,63408,31192,32216,38.2,36408,16963,1061,258,46,7198,63408
37165,36266,17504,18762,37.8,17114,14029,3567,330,5,233,36266
37167,60489,30255,30234,40.5,51333,6548,148,1184,5,337,60489
37169,47224,22914,24310,42.5,44254,2000,289,111,0,198,47224
37171,73551,35948,37603,41.1,67694,2871,338,246,28,1221,73551
37173,13995,6992,7003,40.9,9447,362,3269,37,0,263,13995
37175,32825,15757,17068,49.4,30233,1210,144,158,0,407,32825
37177,4367,2371,1996,44.2,2430,1579,37,90,10,85,4367
37179,201617,99665,101952,36.3,164971,23715,882,3206,70,5571,201617
37181,45183,21017,24166,38.4,19115,22619,129,69,0,2740,45183
37183,905573,441250,464323,34.5,619850,188710,2766,48689,177,27427,905573
37185,20860,10665,10195,45.1,8011,10764,782,81,0,388,20860
37187,13085,6086,6999,43.6,6067,6592,46,11,0,296,13085
37189,51103,25551,25552,28.1,48237,640,94,482,2,447,51103
37191,122419,59952,62467,36.7,70278,38867,194,1190,39,8507,122419
37193,69265,34055,35210,42.4,62652,2991,162,332,0,2303,69265
37195,81020,38568,42452,38.8,41892,31039,288,564,48,5434,81020
37197,38254,18798,19456,41.8,34590,1314,85,21,0,1790,38254
37199,17814,8642,9172,45.3,17312,172,78,20,5,61,17814
38001,2325,1151,1174,50.2,2269,1,31,1,0,0,2325
38003,11047,5505,5542,44.0,10622,58,73,156,0,68,11047
38005,6677,3393,3284,32.0,2928,6,3604,23,3,16,6677
38007,838,445,393,49.3,815,0,0,23,0,0,838
38009,6449,3326,3123,47.4,6120,32,164,1,5,8,6449
38011,3154,1561,1593,46.3,3066,0,15,0,0,53,3154
38013,2011,988,1023,46.2,1958,25,0,11,0,9,2011
38015,81941,40252,41689,37.3,76391,463,3003,375,49,110,81941
38017,150240,75815,74425,31.7,137444,3575,1968,3502,66,966,150240
38019,3974,2009,1965,50.7,3858,0,44,20,0,0,3974
38021,5280,2648,2632,41.8,5098,60,30,0,0,35,5280
38023,2095,1149,946,51.7,2056,0,33,6,0,0,2095
38025,3648,1874,1774,43.3,3110,10,322,51,4,31,3648
38027,2393,1191,1202,48.4,2300,5,50,0,0,27,2393
38029,3544,1805,1739,50.5,3521,0,9,0,0,5,3544
38031,3368,1699,1669,45.7,3325,1,12,8,0,0,3368
38033,1646,819,827,43.0,1606,1,27,0,0,2,1646
38035,66890,34371,32519,29.5,60580,1497,1893,1279,13,325,66890
38037,2380,1152,1228,49.7,2253,11,47,32,0,0,2380
38039,2393,1171,1222,52.0,2354,0,22,8,0,0,2393
38041,2502,1201,1301,50.9,2444,9,26,0,0,3,2502
38043,2426,1274,1152,48.5,2369,0,6,0,0,31,2426
38045,4141,2153,1988,48.6,4106,9,7,0,0,8,4141
38047,1972,973,999,51.1,1970,2,0,0,0,0,1972
38049,5478,2842,2636,45.4,5340,3,32,22,4,3,5478
38051,2813,1359,1454,53.1,2748,5,8,10,0,0,2813
38053,6692,3440,3252,37.6,5127,12,1366,38,0,42,6692
38055,9020,4590,4430,49.2,8282,2,665,13,0,0,9020
38057,8400,4338,4062,46.8,8070,73,171,20,0,0,8400
38059,27439,13722,13717,39.9,25731,131,1021,48,0,143,27439
38061,7830,4238,3592,36.9,5145,32,2259,3,0,64,7830
38063,3115,1602,1513,51.4,3036,40,25,0,0,0,3115
38065,1875,967,908,44.0,1805,0,27,1,0,11,1875
38067,7383,3767,3616,47.1,7060,6,189,2,0,44,7383
38069,4378,2227,2151,47.4,4171,4,164,9,0,3,4378
38071,11450,5788,5662,42.3,10063,90,944,81,0,35,11450
38073,5498,2795,2703,44.5,5379,12,51,6,0,5,5498
38075,2468,1314,1154,45.8,2393,0,25,36,0,0,2468
38077,16295,8574,7721,39.9,15499,63,263,80,44,35,16295
38079,14015,6930,7085,30.4,2887,58,10829,0,13,25,14015
38081,3876,2057,1819,45.8,3768,28,20,18,0,30,3876
38083,1282,645,637,53.4,1236,5,27,0,3,0,1282
38085,4193,2142,2051,26.2,529,11,3463,13,3,11,4193
38087,768,403,365,49.3,768,0,0,0,0,0,768
38089,24682,12440,12242,38.0,23405,146,208,290,70,236,24682
38091,1976,1060,916,47.8,1961,0,0,0,0,8,1976
38093,20965,10604,10361,41.9,20031,91,291,56,0,157,20965
38095,2264,1108,1156,48.8,2197,6,23,0,0,0,2264
38097,8105,4045,4060,42.2,7827,22,91,4,0,58,8105
38099,11131,5585,5546,45.6,10337,18,181,12,0,479,11131
38101,62013,31516,30497,32.5,55979,1609,1265,543,80,569,62013
38103,4228,2050,2178,51.4,4147,0,10,0,5,0,4228
38105,23287,11957,11330,37.6,21315,54,1156,68,13,282,23287
39001,28524,14099,14425,39.8,27875,89,70,6,0,16,28524
39003,106079,53361,52718,38.1,88630,12699,269,725,0,853,106079
39005,53203,25890,27313,39.5,51720,407,105,303,9,137,53203
39007,101262,50547,50715,41.1,94328,3683,172,328,0,635,101262
39009,64592,32400,32192,26.4,59315,1888,67,1914,0,195,64592
39011,45934,22826,23108,40.2,44926,142,70,156,28,96,45934
39013,70182,35469,34713,43.5,65828,2467,93,255,5,175,70182
39015,44666,22051,22615,39.9,43541,405,40,45,0,64,44666
39017,368029,180206,187823,36.1,318829,27228,728,9273,148,4664,368029
39019,28828,14442,14386,43.2,28252,204,22,38,0,16,28828
39021,39982,19886,20096,39.7,37897,842,60,128,29,131,39982
39023,138278,66877,71401,40.6,119714,11841,281,843,9,1727,138278
39025,197543,97414,100129,38.6,189441,2803,491,1995,8,734,197543
39027,42161,20608,21553,38.4,39993,858,53,200,0,177,42161
39029,107598,54017,53581,42.3,102885,2492,63,382,11,466,107598
39031,36880,18188,18692,41.3,35811,429,56,94,0,83,36880
39033,43623,21142,22481,42.2,42313,337,24,169,0,75,43623
39035,1278024,606599,671425,40.2,824432,378771,2604,33783,234,12906,1278024
39037,52776,25851,26925,40.8,51686,258,84,141,0,90,52776
39039,38975,19217,19758,39.1,36195,647,163,114,9,1107,38975
39041,174454,86011,88443,37.2,156541,6366,249,7322,0,1007,174454
39043,76952,37712,39240,43.3,67307,6433,317,407,44,426,76952
39045,146138,72387,73751,38.2,131999,8090,163,1782,0,802,146138
39047,28931,14244,14687,39.4,27380,627,112,154,9,108,28931
39049,1167484,568601,598883,33.5,818220,246939,2459,46047,423,17965,1167484
39051,42635,20820,21815,39.6,40799,216,82,130,0,751,42635
39053,30877,15073,15804,39.8,29250,712,7,157,0,125,30877
39055,93485,45932,47553,43.3,90694,1044,64,530,0,80,93485
39057,161936,79238,82698,37.0,140174,11824,368,4815,12,673,161936
39059,40056,19719,20337,40.8,38468,761,90,99,1,41,40056
39061,801350,384730,416620,37.1,555920,205756,1464,16064,116,4876,801350
39063,75043,36241,38802,38.4,70460,1197,157,1272,48,985,75043
39065,31986,15851,16135,34.8,30877,241,86,186,19,60,31986
39067,15818,7815,8003,44.2,15170,419,16,9,0,29,15818
39069,28246,14042,14204,39.6,27006,128,37,126,31,527,28246
39071,43454,21356,22098,39.0,41833,432,52,86,0,0,43454
39073,29372,14731,14641,41.9,28604,212,9,89,0,57,29372
39075,42501,21264,21237,29.7,41955,169,19,25,27,114,42501
39077,59628,29276,30352,37.6,56273,614,237,195,0,1273,59628
39079,33134,16152,16982,39.1,32124,211,65,58,0,79,33134
39081,69343,33208,36135,43.9,63625,3726,148,238,19,101,69343
39083,60791,29669,31122,39.0,58833,446,38,502,7,72,60791
39085,229873,112045,117828,42.5,214594,7617,204,2917,13,1322,229873
39087,62441,30256,32185,40.0,59804,1506,97,26,0,127,62441
39089,166135,81253,84882,39.1,155098,5535,221,1364,52,407,166135
39091,45816,22453,23363,39.6,43682,658,106,263,0,136,45816
39093,301108,148036,153072,40.1,255556,25238,994,2904,80,6678,301108
39095,441198,213780,227418,37.1,328791,84171,1347,7120,163,6701,441198
39097,43213,23657,19556,39.0,39247,2751,148,304,12,152,43213
39099,238352,115339,123013,42.9,191858,37898,388,1716,40,2204,238352
39101,66514,35132,31382,40.0,60324,3446,318,382,14,374,66514
39103,172334,84720,87614,40.5,165340,2117,227,1587,12,834,172334
39105,23664,11728,11936,41.5,23099,316,34,34,0,0,23664
39107,40866,20477,20389,39.4,39995,112,44,238,78,81,40866
39109,102657,50505,52152,40.8,97118,2324,141,1239,0,323,102657
39111,14679,7324,7355,45.0,14434,36,32,0,0,0,14679
39113,535626,257221,278405,39.2,396579,112269,555,9906,26,4022,535626
39115,15042,7455,7587,43.2,14058,458,42,65,0,36,15042
39117,34895,17377,17518,39.6,34017,217,12,93,0,87,34895
39119,85996,41500,44496,39.6,80100,2877,159,269,0,196,85996
39121,14643,8472,6171,44.5,13393,1052,26,0,0,16,14643
39123,41445,20521,20924,46.5,39777,475,41,167,0,389,41445
39125,19522,9656,9866,40.5,18728,181,86,13,7,144,19522
39127,36086,17882,18204,38.3,35336,86,20,68,0,43,36086
39129,55795,29308,26487,38.4,52498,1875,145,213,0,117,55795
39131,28652,14305,14347,39.8,27741,185,105,115,88,0,28652
39133,161178,78637,82541,37.4,148536,6297,173,2464,0,492,161178
39135,42240,20989,21251,41.0,41287,166,71,231,2,7,42240
39137,34445,17208,17237,38.8,33307,86,23,37,0,586,34445
39139,124286,62886,61400,41.0,108498,11078,352,711,0,606,124286
39141,77741,41019,36722,39.8,70451,3545,141,255,7,344,77741
39143,60842,29925,30917,40.9,55865,2082,133,179,23,1033,60842
39145,79122,39096,40026,38.7,74648,2087,174,269,0,303,79122
39147,56630,28316,28314,38.8,53589,1500,121,278,0,457,56630
39149,49359,24540,24819,38.3,46963,834,84,364,37,42,49359
39151,375593,181870,193723,41.2,333935,27292,782,2880,30,934,375593
39153,541788,261847,279941,40.2,437759,77666,808,11785,75,1964,541788
39155,209942,102016,107926,42.8,187213,17067,294,979,8,323,209942
39157,92532,45487,47045,40.8,90001,868,178,261,0,342,92532
39159,52153,24893,27260,36.8,48546,1093,204,1410,0,104,52153
39161,28808,14005,14803,40.2,27911,325,33,88,0,194,28808
39163,13397,6739,6658,39.5,13060,8,0,9,24,11,13397
39165,213146,107159,105987,37.5,193666,7135,219,8156,18,763,213146
39167,61751,30066,31685,42.7,59611,476,30,431,12,102,61751
39169,114644,56583,58061,38.4,109905,1753,179,915,0,338,114644
39171,37779,18798,18981,40.6,36407,392,76,117,86,225,37779
39173,126254,61571,64683,35.1,116210,2970,126,2153,7,2104,126254
39175,22626,11159,11467,41.4,22074,65,0,235,4,135,22626
40001,22470,11228,11242,36.8,10287,67,8077,142,0,179,22470
40003,5631,3330,2301,46.0,4789,129,113,1,0,136,5631
40005,14133,7431,6702,39.3,10572,595,1371,64,4,73,14133
40007,5587,2832,2755,40.9,4908,40,41,8,0,456,5587
40009,22519,12226,10293,35.1,19523,785,441,82,16,356,22519
40011,10651,5882,4769,40.4,8322,605,526,24,7,656,10651
40013,42494,20774,21720,36.8,31831,660,3085,227,5,1394,42494
40015,29403,15167,14236,38.1,18413,831,6590,123,0,1139,29403
40017,116299,57578,58721,35.7,96902,2727,4686,3397,9,2825,116299
40019,47603,23241,24362,38.3,36560,3283,4813,448,67,296,47603
40021,47165,23153,24012,34.5,25088,674,13289,117,25,853,47165
40023,15172,7268,7904,40.6,9727,1513,1248,48,0,196,15172
40025,2451,1256,1195,44.3,2074,14,12,8,0,312,2451
40027,256550,128230,128320,32.7,204939,10462,10540,9300,260,4313,256550
40029,5906,2912,2994,40.5,4299,20,318,10,0,43,5906
40031,123101,63665,59436,31.5,80135,20834,6549,2658,694,2506,123101
40033,6171,3025,3146,40.2,5013,131,536,31,0,136,6171
40035,14922,7542,7380,42.0,10007,468,1869,96,18,49,14922
40037,69934,34763,35171,40.1,55793,1556,5104,319,98,669,69934
40039,27583,13655,13928,31.1,23011,890,1390,330,16,563,27583
40041,41332,20328,21004,44.9,27896,150,9707,531,26,291,41332
40043,4775,2425,2350,42.3,4254,13,157,7,2,14,4775
40045,4095,2047,2048,44.8,3908,12,44,7,0,10,4095
40047,60272,29627,30645,37.5,50923,1689,1391,547,1021,2658,60272
40049,27471,13442,14029,39.7,22819,701,2163,73,1,285,27471
40051,52451,25968,26483,38.2,44931,1176,2594,182,46,959,52451
40053,4536,2260,2276,45.1,4200,26,43,17,0,36,4536
40055,6185,3526,2659,42.1,5038,449,199,2,0,322,6185
40057,2888,1348,1540,41.2,1983,243,57,0,0,443,2888
40059,3672,1819,1853,40.5,3528,11,8,5,0,70,3672
40061,12761,6326,6435,39.6,9487,92,1654,84,2,193,12761
40063,13762,7420,6342,39.9,9367,713,2262,0,0,232,13762
40065,26275,13033,13242,34.3,20407,1899,262,345,61,1464,26275
40067,6445,3172,3273,41.6,5460,35,419,0,0,207,6445
40069,10938,5372,5566,39.4,7957,154,655,74,0,177,10938
40071,46288,22876,23412,39.3,36991,833,4212,314,41,1228,46288
40073,14965,7376,7589,38.3,12871,94,644,11,5,1082,14965
40075,9421,4657,4764,41.8,7598,449,588,27,0,411,9421
40077,11099,5607,5492,39.9,7800,98,1459,45,0,87,11099
40079,50056,25218,24838,38.5,38116,1132,4029,310,25,1575,50056
40081,34106,16914,17192,40.4,29405,649,2011,23,0,168,34106
40083,41982,20747,21235,37.4,34385,3692,1433,263,36,490,41982
40085,9404,4593,4811,41.0,7965,241,719,46,0,49,9404
40087,34471,17117,17354,38.2,29385,251,1711,187,154,467,34471
40089,33144,16201,16943,38.8,22607,2880,5697,28,0,153,33144
40091,20266,9970,10296,46.7,14249,702,3091,50,0,12,20266
40093,7563,3816,3747,43.6,6917,20,297,0,0,175,7563
40095,15774,7770,8004,42.7,11760,259,798,28,0,850,15774
40097,41162,20460,20702,39.2,28087,117,3630,172,16,22,41162
40099,13460,6764,6696,41.4,10349,139,1170,94,0,324,13460
40101,70635,34537,36098,38.0,43806,7899,9459,446,9,665,70635
40103,11540,5630,5910,40.1,9718,220,772,56,0,102,11540
40105,10627,5246,5381,41.5,7304,269,1931,15,64,121,10627
40107,12203,6555,5648,40.3,7857,964,1840,30,0,54,12203
40109,721088,352762,368326,34.3,491985,108431,22069,22015,484,29506,721088
40111,39770,19877,19893,38.7,26264,3543,5335,54,11,155,39770
40113,47650,24006,23644,41.6,31368,5471,6807,106,40,376,47650
40115,31940,15606,16334,38.7,22323,229,5505,192,268,500,31940
40117,16573,8209,8364,41.7,13338,139,1527,32,7,28,16573
40119,77125,39260,37865,27.2,62788,2554,2747,2754,31,546,77125
40121,45570,23354,22216,41.2,33374,1536,4299,217,9,667,45570
40123,37438,18147,19291,35.5,27126,901,2935,134,0,66,37438
40125,69676,33428,36248,37.3,53560,1886,8172,379,68,612,69676
40127,11449,5654,5795,44.4,8624,107,1276,13,10,69,11449
40129,3678,1829,1849,41.8,3346,28,94,0,8,2,3678
40131,87031,43301,43730,38.5,66225,692,11358,960,4,799,87031
40133,25394,12330,13064,39.2,17409,1259,4217,80,12,235,25394
40135,41945,20697,21248,38.9,28210,815,4659,241,0,230,41945
40137,44848,21714,23134,40.1,38460,993,2345,213,81,1032,44848
40139,20620,10531,10089,31.0,14152,205,186,673,0,4785,20620
40141,7981,4046,3935,40.5,6327,623,182,11,4,346,7981
40143,602692,293961,308731,35.3,436770,62672,28402,14250,485,18157,602692
40145,73067,36108,36959,38.0,55906,2525,6331,976,0,962,73067
40147,51112,24479,26633,41.0,40408,1223,4096,706,8,562,51112
40149,11616,5701,5915,39.3,10562,101,249,9,3,306,11616
40151,8741,4625,4116,35.6,7835,267,166,32,7,160,8741
40153,20232,10687,9545,37.2,18416,238,399,144,3,453,20232
41001,16092,8098,7994,48.1,15378,32,240,69,7,38,16092
41003,85501,42842,42659,32.1,75397,860,616,4738,303,1003,85501
41005,377206,185962,191244,40.6,339189,3122,2485,13634,837,4654,377206
41007,37068,18215,18853,43.5,33958,204,143,470,51,810,37068
41009,49317,24665,24652,41.5,45912,111,701,491,52,537,49317
41011,62937,31324,31613,47.2,57000,322,1659,762,27,611,62937
41013,21102,10501,10601,45.7,19849,46,310,53,8,344,21102
41015,22344,10932,11412,53.2,20658,27,299,77,4,261,22344
41017,158884,78546,80338,40.4,148163,485,1222,1810,250,3233,158884
41019,107391,53036,54355,46.1,100130,352,1912,885,185,601,107391
41021,1904,1010,894,50.2,1771,15,15,0,5,65,1904
41023,7366,3649,3717,50.0,7032,16,35,9,2,23,7366
41025,7359,3809,3550,46.1,6845,16,226,57,6,15,7359
41027,22207,10967,11240,37.8,19983,114,274,316,50,996,22207
41029,203613,99285,104328,42.0,187279,1173,1716,2036,506,2846,203613
41031,21746,11297,10449,40.1,15511,159,3651,126,109,1644,21746
41033,82636,40195,42441,47.1,77667,296,1298,521,137,492,82636
41035,66350,32917,33433,41.6,58405,454,2855,790,89,1045,66350
41037,7886,4179,3707,48.0,7114,40,132,39,11,272,7886
41039,351794,173048,178746,38.8,314114,3351,4173,8495,832,6542,351794
41041,45992,22348,23644,49.6,40666,129,1303,588,87,1362,45992
41043,116871,57667,59204,39.0,106970,557,2334,1082,233,2969,116871
41045,31057,16950,14107,36.2,25936,390,276,410,35,2554,31057
41047,315391,157207,158184,35.1,253676,3238,5189,5842,2044,33623,315391
41049,11146,5693,5453,36.6,9995,16,57,70,10,509,11146
41051,737110,364277,372833,35.9,578509,42365,7433,48982,4557,25122,737110
41053,75448,36561,38887,37.4,66132,313,1291,1625,383,2529,75448
41055,1865,917,948,46.7,1764,2,25,1,0,18,1865
41057,25254,12778,12476,47.9,23416,153,201,183,12,708,25254
41059,75846,39512,36334,35.7,66632,547,1605,685,105,2851,75846
41061,25670,12623,13047,40.1,24041,96,94,241,215,208,25670
41063,6938,3449,3489,50.8,6667,38,45,13,6,34,6938
41065,25113,12490,12623,41.8,21386,119,1237,247,107,1626,25113
41067,531818,261748,270070,35.4,409015,9334,6199,46982,2642,37345,531818
41069,1287,637,650,56.0,1235,0,8,1,0,14,1287
41071,99119,49852,49267,37.1,85312,885,1378,1322,225,6580,99119
42001,101352,49882,51470,41.3,93884,1607,134,744,0,3384,101352
42003,1224772,586579,638193,41.2,998821,159897,1443,34487,394,4698,1224772
42005,68942,34167,34775,44.6,67494,635,25,142,0,189,68942
42007,170614,82437,88177,44.2,155603,10317,144,857,14,350,170614
42009,49680,24750,24930,43.8,48747,295,75,127,13,72,49680
42011,411094,201662,209432,39.4,348705,19523,850,5436,124,27587,411094
42013,127133,61782,65351,42.1,122432,2242,113,907,0,185,127133
42015,62628,30873,31755,43.1,61089,344,62,398,2,150,62628
42017,625485,306898,318587,41.9,562737,22785,540,24607,138,5546,625485
42019,183946,90624,93322,41.3,177829,2111,107,1954,8,373,183946
42021,143305,70845,72460,43.7,134809,5062,114,773,82,570,143305
42023,5058,2496,2562,47.9,4972,31,4,10,0,0,5058
42025,65101,32183,32918,44.0,62472,872,177,335,0,346,65101
42027,153758,79677,74081,28.9,137411,4735,397,8075,36,1092,153758
42029,499548,245462,254086,39.4,436742,30005,329,19198,110,4761,499548
42031,39991,19373,20618,39.6,38852,503,16,210,0,146,39991
42033,81668,41771,39897,42.8,78262,1765,103,468,0,332,81668
42035,39261,19173,20088,38.7,37942,591,58,164,9,66,39261
42037,66984,31957,35027,39.7,64330,1143,82,647,0,203,66984
42039,88492,43158,45334,41.7,84946,1551,121,363,15,136,88492
42041,235314,115569,119745,40.5,214006,7324,372,6571,58,1794,235314
42043,267891,129579,138312,39.2,197274,47186,408,8387,51,5950,267891
42045,558874,267868,291006,38.8,407100,110537,409,26802,85,4066,558874
42047,31981,15871,16110,45.1,31438,178,48,122,0,101,31981
42049,280181,137693,142488,38.5,247864,19659,728,3198,17,2482,280181
42051,136914,67184,69730,43.3,127766,5837,204,512,18,216,136914
42053,7664,5073,2591,43.1,6095,1245,63,0,0,98,7664
42055,149554,73125,76429,40.2,139798,5232,326,1401,0,1043,149554
42057,14829,7424,7405,42.0,14465,182,40,21,0,22,14829
42059,38614,19866,18748,41.3,35586,2082,100,89,3,161,38614
42061,45931,24411,21520,41.5,42616,2405,32,179,0,153,45931
42063,88648,44115,44533,38.2,84033,2271,141,830,33,409,88648
42065,45051,22303,22748,43.0,44293,145,60,86,1,62,45051
42067,24664,12243,12421,41.1,24109,177,40,93,0,65,24664
42069,214353,102995,111358,42.1,200321,5385,274,3516,75,1823,214353
42071,519913,254054,265859,38.0,467604,18411,847,10051,154,13064,519913
42073,90885,43816,47069,43.7,85239,3584,68,327,17,238,90885
42075,133578,65125,68453,40.8,119364,2544,131,1347,0,6898,133578
42077,350165,169873,180292,39.3,284775,22225,807,10465,51,23177,350165
42079,320555,156765,163790,42.7,294883,11509,490,3047,58,6932,320555
42081,116447,57055,59392,41.2,107893,5103,221,770,36,311,116447
42083,43451,22153,21298,41.8,41417,1044,109,217,0,229,43451
42085,116474,57131,59343,42.8,106816,6397,115,821,23,358,116474
42087,46694,22926,23768,42.5,45674,315,31,137,0,30,46694
42089,169346,83724,85622,40.0,133808,22000,233,3313,80,4521,169346
42091,799886,387923,411963,40.6,657641,69139,884,51172,207,5806,799886
42093,18243,8651,9592,43.7,17365,278,16,355,0,89,18243
42095,297519,145530,151989,40.9,259544,14598,532,7459,42,8252,297519
42097,94441,47507,46934,43.2,90454,2227,171,341,10,462,94441
42099,45791,22928,22863,41.0,44552,314,44,87,1,292,45791
42101,1525811,719297,806514,33.5,631799,662657,4473,96995,1594,90949,1525811
42103,57437,28712,28725,43.8,51583,2929,55,415,93,1002,57437
42105,17466,8717,8749,44.8,17133,83,24,53,2,22,17466
42107,147935,75168,72767,43.2,140308,3997,72,870,0,1017,147935
42109,39620,19604,20016,39.2,38467,408,50,263,24,195,39620
42111,77638,40001,37637,44.4,74769,1789,88,233,0,141,77638
42113,6453,3290,3163,49.7,6138,126,91,17,19,35,6453
42115,43171,21698,21473,45.1,42400,226,99,84,0,22,43171
42117,42081,20682,21399,42.3,40955,357,67,187,0,46,42081
42119,44944,24669,20275,38.4,39161,3275,106,536,55,946,44944
42121,54865,26859,28006,44.4,53240,436,39,182,8,23,54865
42123,41613,20711,20902,45.1,40795,199,69,174,3,66,41613
42125,207916,101094,106822,43.5,196156,6681,94,1399,0,434,207916
42127,52299,27494,24805,45.6,49484,1537,117,282,11,254,52299
42129,364877,177558,187319,45.1,347766,8447,331,2775,0,731,364877
42131,28221,14121,14100,42.0,27503,219,40,113,1,76,28221
42133,434579,214501,220078,40.1,386289,23231,594,5430,46,9087,434579
44001,49796,23814,25982,43.0,47716,199,68,737,0,124,49796
44003,166066,80020,86046,42.6,155004,2593,196,3905,0,1800,166066
44005,82503,40230,42273,43.5,74951,3046,100,1262,178,609,82503
44007,627414,303129,324285,37.0,463095,57061,3339,23660,172,60792,627414
44009,126692,61328,65364,41.9,118920,1812,1081,2299,0,966,126692
45001,25387,12350,13037,42.4,17759,7144,18,15,0,31,25387
45003,160169,77538,82631,40.1,111591,39908,413,1086,20,4678,160169
45005,10399,5654,4745,38.3,2479,7668,3,0,0,228,10399
45007,187228,90393,96835,40.0,151044,30021,238,1393,8,1449,187228
45009,15941,7528,8413,38.9,5734,10017,0,60,0,61,15941
45011,22523,10801,11722,38.9,11888,10148,84,73,0,107,22523
45013,162316,80148,82168,41.2,119255,31123,310,1754,11,6755,162316
45015,179773,89529,90244,34.6,121594,45337,1180,4322,131,3042,179773
45017,15134,7295,7839,43.9,8339,6432,18,3,0,76,15134
45019,352548,170909,181639,35.8,231974,105458,1034,4303,150,4306,352548
45021,55351,26739,28612,38.2,42323,11146,235,308,0,559,55351
45023,33028,15990,17038,40.3,19709,12532,196,76,5,45,33028
45025,46462,22592,23870,39.2,30006,15175,123,188,0,147,46462
45027,34746,17141,17605,41.9,16519,17388,58,0,0,402,34746
45029,38665,18620,20045,41.0,22362,15440,392,21,37,262,38665
45031,68500,32437,36063,39.3,38685,28262,128,238,0,381,68500
45033,31733,14788,16945,37.5,15160,14899,738,5,0,475,31733
45035,136836,66408,70428,35.6,94229,34468,928,1892,92,850,136836
45037,26763,14402,12361,40.6,15921,10162,64,46,0,304,26763
45039,23804,11486,12318,42.5,9111,14372,0,21,0,108,23804
45041,136714,64027,72687,37.5,76054,56292,167,1498,0,498,136714
45043,60285,28700,31585,45.6,38223,20450,49,222,0,1013,60285
45045,452931,219814,233117,37.2,346539,81586,1064,9060,297,5946,452931
45047,69531,32611,36920,38.3,44043,21106,33,648,71,2466,69531
45049,20987,10736,10251,38.9,8937,11284,31,42,0,453,20987
45051,270943,132335,138608,41.4,216017,36729,811,3171,133,9509,270943
45053,24792,12972,11820,35.5,10510,11182,4,107,0,2253,24792
45055,61583,29860,31723,40.8,44193,15557,281,281,0,752,61583
45057,76364,37836,38528,40.1,55773,18322,310,472,22,774,76364
45059,66623,32194,34429,40.1,47630,16689,60,166,133,859,66623
45061,19160,9940,9220,38.4,6322,12344,6,29,0,300,19160
45063,262424,127999,134425,37.7,212467,37717,813,3533,126,2414,262424
45065,10140,5473,4667,49.9,4953,4947,0,20,0,10,10140
45067,33038,15106,17932,39.1,13540,18711,43,122,0,346,33038
45069,28750,15220,13530,39.1,11905,14579,1039,85,23,259,28750
45071,37432,18274,19158,39.9,23184,11036,11,145,0,2044,37432
45073,74038,36414,37624,43.2,65891,5569,136,343,0,757,74038
45075,92229,43554,48675,37.9,31830,57573,518,826,0,796,92229
45077,119167,59412,59755,34.8,105724,7643,426,1917,35,1338,119167
45079,384596,187041,197555,32.8,182806,176294,571,8794,345,7275,384596
45081,19758,10141,9617,40.4,12700,5331,0,6,0,1524,19758
45083,284540,138037,146503,38.0,208863,58556,685,5765,93,5693,284540
45085,107279,51686,55593,35.6,52527,49957,252,1363,18,1330,107279
45087,28804,13733,15071,42.4,19208,8886,33,39,0,66,28804
45089,34361,16797,17564,40.6,10842,22814,45,39,0,269,34361
45091,226576,109238,117338,37.2,172103,42450,1574,3138,41,2001,226576
46003,2726,1347,1379,41.7,2579,60,30,17,0,4,2726
46005,17372,8737,8635,41.0,15908,86,158,709,39,252,17372
46007,3432,1720,1712,27.8,978,24,2305,13,0,0,3432
46009,7041,4036,3005,43.5,6344,54,447,21,0,74,7041
46011,31973,16402,15571,26.1,29916,247,295,746,24,176,31973
46013,36562,17890,18672,39.4,34240,286,1199,392,6,16,36562
46015,5236,2558,2678,41.5,4647,0,480,0,0,7,5236
46017,1950,987,963,26.4,339,9,1539,0,0,0,1950
46019,10122,5036,5086,40.1,9651,47,105,45,0,28,10122
46021,1419,682,737,50.5,1400,0,15,4,0,0,1419
46023,9127,4508,4619,39.0,5934,18,2846,6,0,20,9127
46025,3653,1829,1824,45.4,3499,30,25,20,0,32,3653
46027,13966,6890,7076,25.5,12665,123,569,245,0,197,13966
46029,27284,13493,13791,38.2,26054,85,764,118,0,117,27284
46031,4046,2060,1986,29.8,1244,7,2707,8,0,9,4046
46033,8219,4128,4091,50.5,7713,26,337,2,0,31,8219
46035,19513,9776,9737,38.4,18554,77,411,62,0,20,19513
46037,5673,2879,2794,47.7,5020,0,549,18,0,4,5673
46039,4376,2256,2120,43.6,4315,28,15,0,0,4,4376
46041,5358,2669,2689,29.1,1156,24,3978,0,0,15,5358
46043,2992,1486,1506,48.1,2897,0,63,0,1,0,2992
46045,4050,2111,1939,45.9,3974,0,33,13,0,3,4050
46047,7028,3502,3526,51.2,6318,19,382,72,5,8,7028
46049,2374,1175,1199,45.6,2346,0,22,0,0,0,2374
46051,7324,3763,3561,45.0,7137,52,41,7,0,64,7324
46053,4251,2173,2078,48.4,3823,6,314,10,0,0,4251
46055,1852,948,904,48.0,1804,4,25,7,0,0,1852
46057,5875,2987,2888,37.4,5730,15,9,0,0,67,5875
46059,3394,1711,1683,49.3,3383,0,8,2,0,0,3394
46061,3366,1698,1668,35.6,3305,0,32,5,10,0,3366
46063,1367,702,665,40.6,1300,3,17,0,0,4,1367
46065,17064,8360,8704,40.6,14478,105,1571,37,8,297,17064
46067,7283,3587,3696,46.9,7136,2,93,3,0,0,7283
46069,1437,710,727,42.6,1262,0,119,9,0,5,1437
46071,3067,1548,1519,33.8,1564,0,1384,2,0,21,3067
46073,2047,1016,1031,49.3,1997,0,29,4,0,17,2047
46075,1084,507,577,40.2,1025,13,43,3,0,0,1084
46077,5159,2604,2555,46.8,5049,14,17,27,0,19,5159
46079,11364,5729,5635,41.2,10983,70,94,59,0,40,11364
46081,24063,11974,12089,41.2,22578,69,919,181,0,109,24063
46083,45055,22590,22465,33.2,43245,289,246,569,0,149,45055
46085,3752,1988,1764,36.8,2174,0,1416,25,0,0,3752
46087,5592,2809,2783,42.4,5483,5,31,15,0,14,5592
46089,2485,1298,1187,50.1,2463,1,20,1,0,0,2485
46091,4631,2464,2167,43.0,3950,2,355,0,0,66,4631
46093,25456,13154,12302,36.1,23203,208,554,199,25,361,25456
46095,2057,1020,1037,31.5,778,0,1186,0,0,0,2057
46097,2365,1184,1181,47.1,2305,1,22,0,0,3,2365
46099,170342,85048,85294,34.7,150083,6490,4419,2764,3,3415,170342
46101,6474,3269,3205,40.3,5251,0,875,58,4,48,6474
46103,101240,50518,50722,36.7,84667,1039,8916,1147,27,672,101240
46105,2890,1494,1396,49.5,2814,0,35,0,0,5,2890
46107,2327,1113,1214,50.2,2281,0,23,8,0,0,2327
46109,10158,5076,5082,39.7,6194,57,3516,20,0,14,10158
46111,2357,1225,1132,45.8,2318,0,10,7,0,4,2357
46113,13683,6542,7141,23.5,486,18,13091,2,4,35,13683
46115,6483,3284,3199,44.2,6326,9,85,0,0,30,6483
46117,2940,1488,1452,43.5,2575,0,273,0,0,20,2940
46119,1382,762,620,47.2,1317,0,37,0,0,0,1382
46121,9711,4824,4887,22.9,1014,20,8211,68,0,16,9711
46123,5608,2793,2815,44.0,4650,44,667,19,0,13,5608
46125,8344,4228,4116,43.7,8105,30,33,1,0,68,8344
46127,14377,7229,7148,40.4,13642,93,107,106,0,134,14377
46129,5443,2705,2738,46.8,4468,0,847,19,0,0,5443
46135,22434,11713,10721,41.1,20770,408,565,154,1,289,22434
46137,2796,1342,1454,26.3,659,14,2003,11,0,0,2796
47001,75039,36408,38631,42.4,69536,2900,214,911,0,90,75039
47003,45060,22425,22635,36.5,38902,3174,385,348,7,882,45060
47005,16420,8115,8305,46.0,15755,413,46,53,0,9,16420
47007,12898,7070,5828,42.2,12185,539,30,7,0,1,12898
47009,123086,59659,63427,41.6,115009,3603,383,985,0,1432,123086
47011,99229,48280,50949,38.3,91387,4155,149,855,330,916,99229
47013,40629,19855,20774,41.8,39715,200,73,130,0,127,40629
47015,13797,6791,7006,40.4,13232,200,24,52,0,141,13797
47017,28486,13784,14702,42.0,24845,2908,68,21,2,124,28486
47019,57531,28225,29306,42.3,55411,732,105,94,0,239,57531
47021,39103,19683,19420,39.5,37509,597,96,213,0,246,39103
47023,17043,8253,8790,37.6,14981,1769,55,62,15,47,17043
47025,32025,15725,16300,41.5,31086,282,50,214,0,4,32025
47027,7842,3899,3943,45.1,7553,213,0,0,0,39,7842
47029,35631,17310,18321,42.8,33686,620,44,116,0,473,35631
47031,52853,25631,27222,38.8,48433,1400,94,533,51,832,52853
47033,14567,7055,7512,40.3,11797,1995,9,26,0,560,14567
47035,56144,27121,29023,48.3,54501,138,148,201,0,210,56144
47037,629113,304566,324547,33.9,396049,174582,1393,19586,270,24074,629113
47039,11732,5699,6033,44.3,11065,301,3,35,4,151,11732
47041,18770,9505,9265,40.2,17822,301,11,43,0,449,18770
47043,49704,24274,25430,38.4,45972,2099,47,250,0,459,49704
47045,38234,18559,19675,39.5,31226,5605,12,109,8,440,38234
47047,38370,19024,19346,41.8,26442,10864,42,247,2,422,38370
47049,17945,8825,9120,42.4,17586,39,67,23,0,0,17945
47051,40972,19921,21051,41.6,37098,1970,17,189,0,675,40972
47053,49594,23526,26068,40.1,39015,9286,142,110,14,308,49594
47055,29439,14453,14986,42.2,25460,3195,18,153,11,190,29439
47057,22613,11249,11364,42.1,21910,115,2,1,0,264,22613
47059,68755,33752,35003,42.6,65771,1561,95,272,20,362,68755
47061,13751,6822,6929,41.8,11422,95,86,51,0,41,13751
47063,62528,30268,32260,39.1,57361,2638,122,435,59,1026,62528
47065,337023,162196,174827,39.1,251934,68448,681,6267,62,4717,337023
47067,6759,3357,3402,42.3,6620,20,8,17,0,0,6759
47069,27193,14860,12333,39.7,15323,11235,92,182,0,71,27193
47071,25987,12534,13453,42.9,24456,910,79,99,0,52,25987
47073,56725,27775,28950,42.3,54790,773,300,273,0,240,56725
47075,18673,8776,9897,39.9,8775,9188,34,64,0,230,18673
47077,27835,13433,14402,39.5,24865,2257,13,26,8,172,27835
47079,32271,15666,16605,44.1,28919,2608,35,31,0,38,32271
47081,24481,12900,11581,40.4,22712,1280,29,20,0,99,24481
47083,8375,4196,4179,41.3,7957,162,5,10,0,15,8375
47085,18428,8955,9473,40.7,17545,541,120,12,0,77,18428
47087,11526,5758,5768,44.5,11236,37,0,7,0,84,11526
47089,51541,25343,26198,40.5,49049,1354,122,10,0,182,51541
47091,18199,9813,8386,43.5,17518,501,54,17,0,34,18199
47093,433207,210569,222638,37.2,374285,39457,815,8074,114,2892,433207
47095,7780,4902,2878,39.7,5399,2052,30,13,0,112,7780
47097,27772,14519,13253,36.2,17358,9788,111,79,9,129,27772
47099,41779,20395,21384,39.8,39932,710,127,166,0,262,41779
47101,12050,6112,5938,41.1,11439,263,56,10,0,176,12050
47103,33295,16201,17094,41.9,29754,1609,170,9,7,365,33295
47105,48586,23747,24839,45.9,46326,537,71,351,17,617,48586
47107,52325,25349,26976,41.0,48638,2167,75,306,0,164,52325
47109,26001,12772,13229,42.0,23906,1462,61,56,0,111,26001
47111,22265,10934,11331,38.3,21328,89,44,130,0,420,22265
47113,97976,46599,51377,36.8,59127,35520,182,1075,61,659,97976
47115,28184,13873,14311,42.3,26474,396,21,99,0,85,28184
47117,30585,14976,15609,39.3,27297,1746,36,27,0,586,30585
47119,80965,39098,41867,37.9,68072,10051,201,487,12,683,80965
47121,11696,5914,5782,43.2,11199,195,0,0,0,0,11696
47123,44680,22192,22488,41.5,42568,845,211,132,3,113,44680
47125,173138,85063,88075,30.2,125335,33312,1096,3652,727,2534,173138
47127,6349,3155,3194,43.2,5956,148,26,5,0,85,6349
47129,21882,12037,9845,40.0,20689,698,48,64,0,6,21882
47131,31721,15367,16354,41.2,27732,3346,48,56,0,153,31721
47133,22040,10890,11150,41.3,21596,150,18,26,0,0,22040
47135,7856,3948,3908,43.1,7487,295,0,0,0,0,7856
47137,5108,2572,2536,47.3,5049,23,0,0,0,0,5108
47139,16756,8403,8353,42.5,16351,30,59,0,0,42,16756
47141,72172,35651,36521,35.9,67900,1678,98,819,0,676,72172
47143,31817,15623,16194,40.0,30183,817,58,22,0,318,31817
47145,54027,26616,27411,44.9,51094,1441,113,184,29,95,54027
47147,66143,32592,33551,37.7,58726,5017,274,158,66,1010,66143
47149,263815,130377,133438,32.4,212818,33361,785,8122,65,3292,263815
47151,22196,10915,11281,37.9,21953,21,87,33,0,0,22196
47153,14173,7003,7170,40.6,12971,31,189,0,14,193,14173
47155,90218,44410,45808,41.2,86458,622,259,929,13,801,90218
47157,929437,443391,486046,34.5,384952,482411,2095,21889,235,22458,929437
47159,19157,9459,9698,40.2,18092,523,75,97,0,120,19157
47161,13262,6674,6588,42.8,12445,224,169,155,0,154,13262
47163,156675,75527,81148,43.5,149059,2697,612,930,35,1034,156675
47165,161206,78413,82793,38.7,144552,10969,630,1891,25,1334,161206
47167,61038,29971,31067,37.2,47769,11110,241,406,282,285,61038
47169,7827,3965,3862,38.0,6760,773,21,174,0,0,7827
47171,18287,8976,9311,44.7,17755,193,50,0,0,193,18287
47173,19179,9556,9623,40.1,19043,11,6,11,26,15,19179
47175,5552,2758,2794,43.5,5389,40,0,20,0,0,5552
47177,39767,19734,20033,38.7,36877,1137,74,238,0,887,39767
47179,122840,59930,62910,39.6,113826,4743,348,1474,26,341,122840
47181,17015,9404,7611,41.7,15759,990,27,6,0,119,17015
47183,34802,17092,17710,36.8,30867,2827,110,464,10,139,34802
47185,25863,12666,13197,41.4,24752,465,59,8,0,70,25863
47187,184225,89709,94516,38.5,165902,7982,166,5361,40,1878,184225
47189,114618,56275,58343,39.3,102357,7719,337,1232,86,1422,114618
48001,58269,34613,23656,38.8,43169,12451,404,344,59,1070,58269
48003,15006,7478,7528,33.8,13012,203,515,246,0,808,15006
48005,86550,42423,44127,36.2,68280,13496,467,413,0,2543,86550
48007,23391,11388,12003,48.3,21591,207,69,307,0,284,23391
48009,8944,4495,4449,42.9,8596,58,60,46,0,104,8944
48011,1820,888,932,44.8,1717,19,11,0,1,42,1820
48013,45091,22257,22834,35.8,36395,290,273,104,0,6483,45091
48015,28372,14209,14163,40.4,24187,2757,13,18,0,934,28372
48017,7096,3752,3344,33.9,6417,129,2,12,0,536,7096
48019,20477,10016,10461,48.5,19233,138,163,72,0,509,20477
48021,74023,37969,36054,38.3,61425,5998,725,561,0,4026,74023
48023,3706,1768,1938,50.2,3520,59,29,0,0,84,3706
48025,32083,19410,12673,35.4,21767,2881,42,130,0,6617,32083
48027,310155,153916,156239,29.7,206376,65994,1918,8840,2274,10195,310155
48029,1719902,843432,876470,32.9,1293143,124773,12953,40684,2365,195362,1719902
48031,10425,5279,5146,46.1,9730,93,249,12,0,229,10425
48033,642,326,316,40.0,632,0,6,0,0,0,642
48035,18114,8970,9144,45.6,17092,261,99,50,0,302,18114
48037,92460,46794,45666,37.6,64891,21751,748,673,154,1911,92460
48039,313813,159519,154294,35.2,235273,38393,1520,17043,44,15565,313813
48041,194087,98228,95859,24.5,146571,21489,713,10168,71,10835,194087
48043,9175,4553,4622,40.6,8311,117,106,118,9,414,9175
48045,1674,872,802,43.9,1539,17,1,9,2,11,1674
48047,7236,3610,3626,32.0,6092,6,0,103,0,1027,7236
48049,38018,18823,19195,39.6,34461,1524,247,118,6,793,38018
48051,17160,8493,8667,41.6,13635,1970,0,217,0,1073,17160
48053,42946,21170,21776,44.0,40411,878,244,162,24,732,42946
48055,38152,19218,18934,35.1,26476,2776,254,61,4,7443,38152
48057,21366,10737,10629,38.2,19081,577,21,479,0,235,21366
48059,13521,6597,6924,42.2,12726,144,6,86,11,123,13521
48061,405819,195407,210412,30.6,367713,2258,611,2746,11,28765,405819
48063,12389,6074,6315,38.0,9631,2269,30,41,0,235,12389
48065,6215,3063,3152,40.6,5884,52,50,15,6,133,6215
48067,30324,14672,15652,43.8,24177,5216,182,128,22,196,30324
48069,7984,4053,3931,33.8,6632,204,43,27,5,380,7984
48071,34562,17398,17164,36.2,28876,2770,169,357,28,1413,34562
48073,50690,25869,24821,37.7,41115,7855,137,172,0,749,50690
48075,7047,4226,2821,35.2,5774,856,0,27,0,325,7047
48077,10718,5303,5415,44.8,10280,80,145,19,0,18,10718
48079,3087,1545,1542,34.2,2404,136,75,2,0,402,3087
48081,3298,1636,1662,48.6,3140,44,17,0,0,68,3298
48083,8817,4416,4401,45.8,8242,187,27,0,0,186,8817
48085,788580,387832,400748,35.1,587645,65972,4022,89813,522,18894,788580
48087,3050,1515,1535,36.7,2649,125,29,15,0,150,3050
48089,20784,10270,10514,43.1,16742,2825,108,90,13,850,20784
48091,108985,53528,55457,42.7,99609,1826,799,774,13,3063,108985
48093,13875,6799,7076,43.4,12960,81,8,88,0,550,13875
48095,4073,2768,1305,40.9,3687,30,8,15,0,298,4073
48097,38427,19083,19344,38.8,34329,1101,401,255,9,1434,38427
48099,75728,37248,38480,29.9,55222,12498,310,1656,629,2216,75728
48101,1600,732,868,49.4,1255,217,8,2,0,40,1600
48103,4359,2188,2171,38.0,3285,123,59,0,0,835,4359
48105,3669,1876,1793,38.1,3346,0,0,1,0,260,3669
48107,6100,2984,3116,37.6,5423,209,6,2,10,292,6100
48109,2386,1085,1301,38.1,2240,13,24,0,4,53,2386
48111,6734,3509,3225,31.4,5492,75,100,49,0,812,6734
48113,2379214,1177560,1201654,32.5,1366988,522637,10067,122340,1381,298469,2379214
48115,13761,8113,5648,33.4,11450,915,119,11,0,990,13761
48117,19275,9484,9791,31.1,16982,85,191,55,0,1394,19275
48119,5240,2580,2660,43.6,4594,428,82,14,0,32,5240
48121,667934,328729,339205,33.0,517920,55003,2606,44142,476,20806,667934
48123,20156,10587,9569,42.7,13779,1920,32,91,13,3855,20156
48125,2399,1293,1106,45.4,2082,131,5,1,0,171,2399
48127,10054,4854,5200,37.0,9374,57,11,10,0,508,10054
48129,3652,1819,1833,40.7,3400,175,11,28,24,11,3652
48131,11821,6150,5671,37.2,10752,164,78,6,13,767,11821
48133,18519,9065,9454,41.2,17031,368,29,15,39,715,18519
48135,138193,68365,69828,31.2,117399,5928,1003,1009,25,8615,138193
48137,2023,983,1040,45.1,1943,5,0,0,0,75,2023
48139,149712,73896,75816,35.0,123150,13233,2198,955,15,7198,149712
48141,801115,388798,412317,31.2,643658,25217,4482,8471,875,99848,801115
48143,38192,18738,19454,30.9,33456,416,283,201,0,3301,38192
48145,17756,8232,9524,39.0,12351,4386,54,185,0,509,17756
48147,33867,17887,15980,40.4,29744,2295,264,145,16,669,33867
48149,24557,12063,12494,47.2,22146,1771,2,22,4,437,24557
48151,3963,2001,1962,42.1,3269,179,34,1,0,391,3963
48153,6439,3149,3290,38.2,5728,150,7,0,0,340,6439
48155,1273,592,681,44.4,1171,10,0,7,0,85,1273
48157,587666,288637,299029,35.1,317324,125758,1488,101219,37,27915,587666
48159,10593,5263,5330,42.5,9763,503,158,25,0,37,10593
48161,19631,10363,9268,41.4,15053,3251,197,42,0,903,19631
48163,17265,10091,7174,31.8,15002,562,10,33,0,1519,17265
48165,17572,8905,8667,29.2,15761,190,248,43,53,863,17572
48167,292874,144823,148051,37.3,229774,40685,1262,8879,98,6506,292874
48169,6295,4014,2281,38.4,5364,342,40,0,16,317,6295
48171,24777,12010,12767,49.8,23863,81,70,47,27,372,24777
48173,1255,698,557,39.8,1181,33,0,0,0,17,1255
48175,7223,3620,3603,44.6,5440,301,7,9,49,1169,7223
48177,19773,9890,9883,36.9,11786,1478,24,21,0,6142,19773
48179,22731,11893,10838,38.4,19880,1095,156,102,0,986,22731
48181,120641,58707,61934,39.4,102182,6914,1571,1002,56,5464,120641
48183,121451,59560,61891,35.4,88247,24389,643,1523,247,4825,121451
48185,26564,14462,12102,39.1,19101,4425,94,171,6,2161,26564
48187,131945,64972,66973,36.5,111231,8256,437,2092,114,5902,131945
48189,36153,18761,17392,32.4,30074,1660,235,155,0,2235,36153
48191,3337,1660,1677,43.5,2899,191,0,14,14,173,3337
48193,8448,4150,4298,46.6,8341,39,0,5,3,9,8448
48195,5556,2808,2748,36.5,4918,9,48,15,16,485,5556
48197,4124,2010,2114,42.3,3404,350,8,42,0,155,4124
48199,54497,26845,27652,38.4,49554,3212,189,321,0,726,54497
48201,4101752,2042408,2059344,32.2,2563910,775085,18103,257467,2581,410493,4101752
48203,65958,32401,33557,37.0,48546,14956,86,389,0,1182,65958
48205,6015,3707,2308,39.2,5114,433,14,6,0,365,6015
48207,5891,3025,2866,43.5,4745,255,10,9,0,716,5891
48209,158464,78884,79580,30.4,125452,5297,805,2129,56,21361,158464
48211,3863,1931,1932,36.3,3400,5,15,0,0,378,3863
48213,78558,38513,40045,42.7,70347,5007,461,395,33,1289,78558
48215,774820,377671,397149,28.3,667330,3883,2658,7873,3,87013,774820
48217,35079,17127,17952,41.2,30931,2387,498,143,0,620,35079
48219,22988,11458,11530,32.9,18860,644,61,70,13,2655,22988
48221,51161,25250,25911,46.2,46753,291,384,248,0,2919,51161
48223,35088,17351,17737,39.1,30506,2775,233,215,10,1043,35088
48225,23512,12762,10750,44.0,15662,6222,14,83,0,1281,23512
48227,34927,19624,15303,37.5,25633,1918,330,287,122,5099,34927
48229,3407,1720,1687,36.1,3123,64,0,20,0,194,3407
48231,85955,42569,43386,37.6,69784,7543,555,963,40,5776,85955
48233,21992,10956,11036,37.2,19419,644,215,84,16,1020,21992
48235,1596,774,822,39.3,1459,50,0,9,0,60,1596
48237,9027,5137,3890,39.4,8363,407,31,27,0,165,9027
48239,14075,6839,7236,39.0,11559,1148,41,0,4,1045,14075
48241,35703,17570,18133,40.3,28464,5912,207,234,32,463,35703
48243,2319,1192,1127,50.2,2084,3,43,2,2,171,2319
48245,251627,128630,122997,36.0,139181,84325,875,8621,124,13777,251627
48247,5257,2885,2372,38.3,4851,78,76,0,0,143,5257
48249,41014,20450,20564,34.5,37212,214,131,131,0,2742,41014
48251,151174,75687,75487,36.2,139581,3918,769,1087,312,2694,151174
48253,20137,12478,7659,39.5,15630,2885,92,112,0,1133,20137
48255,14936,8993,5943,36.9,9405,1361,106,66,61,3664,14936
48257,103385,50881,52504,35.3,86514,10001,465,680,188,2590,103385
48259,33745,16697,17048,43.1,31885,155,16,349,0,909,33745
48261,451,193,258,45.1,438,12,0,0,0,1,451
48263,829,406,423,45.6,815,0,0,0,0,11,829
48265,49469,24005,25464,47.3,45626,870,217,482,50,1309,49469
48267,4577,2354,2223,51.3,4411,20,4,21,0,107,4577
48269,227,122,105,53.9,207,0,0,0,0,20,227
48271,3574,1869,1705,46.4,3419,65,35,34,0,7,3574
48273,31925,16209,15716,28.7,27414,1242,132,735,19,1955,31925
48275,3713,1828,1885,41.4,3111,265,9,0,1,312,3713
48277,49740,23936,25804,40.1,40350,6544,436,370,105,649,49740
48279,13996,6942,7054,36.1,12528,572,58,28,0,590,13996
48281,19837,9828,10009,40.3,17582,940,248,137,25,490,19837
48283,6850,3802,3048,33.9,6007,77,108,32,0,569,6850
48285,19269,9331,9938,45.2,15678,1434,6,20,0,1980,19269
48287,16591,8334,8257,40.7,13974,1879,34,0,0,460,16591
48289,16827,8357,8470,45.0,14003,1262,72,25,0,1286,16827
48291,75662,37191,38471,36.1,60191,8526,297,352,26,4960,75662
48293,23350,12270,11080,38.9,18148,4107,55,105,17,601,23350
48295,3324,1710,1614,36.3,2751,21,72,43,4,372,3324
48297,11526,6285,5241,42.8,10253,551,101,99,0,353,11526
48299,19115,9249,9866,55.3,18323,157,40,14,0,305,19115
48301,85,65,20,47.0,43,0,9,0,0,29,85
48303,278339,137494,140845,30.4,222418,19707,1125,5603,469,20383,278339
48305,5886,2955,2931,40.6,5509,99,86,14,3,120,5886
48307,8281,4093,4188,40.8,7519,89,270,38,0,248,8281
48309,234626,113992,120634,32.8,181949,34584,1129,3345,46,9191,234626
48311,696,417,279,41.9,669,0,6,0,0,0,696
48313,13590,7886,5704,34.3,10098,2862,28,39,0,491,13590
48315,10544,5167,5377,48.8,7830,2538,12,69,0,31,10544
48317,4804,2369,2435,35.1,4153,120,47,0,0,477,4804
48319,3978,2032,1946,49.8,3932,0,12,0,0,21,3978
48321,36653,18259,18394,38.1,29836,4011,123,726,79,1077,36653
48323,54107,26388,27719,30.1,48983,90,756,83,0,3369,54107
48325,46009,23540,22469,37.9,41052,1267,219,258,0,2339,46009
48327,2232,1103,1129,43.7,2108,25,9,0,0,18,2232
48329,138472,68108,70364,33.3,117967,9249,753,1944,5,6165,138472
48331,24691,12164,12527,40.6,20704,2291,258,56,0,864,24691
48333,4880,2344,2536,47.2,4755,28,0,0,0,87,4880
48335,9367,5824,3543,35.4,7136,956,37,53,0,845,9367
48337,19737,9714,10023,42.6,18797,24,51,81,0,376,19737
48339,458339,227220,231119,36.2,402030,18758,1671,9975,272,14954,458339
48341,21765,11125,10640,30.8,16392,360,140,1396,6,2843,21765
48343,12914,6206,6708,43.0,9093,2972,23,6,0,514,12914
48345,1153,634,519,43.0,1100,24,7,1,0,21,1153
48347,64647,30811,33836,29.7,49059,12079,335,856,0,1599,64647
48349,47739,23619,24120,37.1,36365,7041,1178,288,0,2005,47739
48351,14372,7367,7005,40.4,10950,2950,28,162,95,166,14372
48353,15104,7500,7604,38.2,12627,604,85,15,0,1171,15104
48355,340568,167057,173511,35.0,293320,13809,1113,5519,277,19687,340568
48357,10314,5246,5068,31.1,7969,68,106,35,0,1749,10314
48359,2048,992,1056,39.3,1866,20,12,12,4,46,2048
48361,82306,40722,41584,38.7,71910,7256,475,946,19,982,82306
48363,28010,13779,14231,40.3,24698,693,205,106,0,1758,28010
48365,23814,11696,12118,39.3,18353,4046,91,22,0,833,23814
48367,116820,59104,57716,38.9,109442,2056,1022,703,8,1874,116820
48369,10172,5216,4956,32.2,9280,93,60,0,9,570,10172
48371,15510,8733,6777,36.1,13712,854,24,74,0,676,15510
48373,45618,24251,21367,43.2,37728,5184,565,237,0,1029,45618
48375,121099,61927,59172,32.8,94439,12213,1059,4679,71,4875,121099
48377,7678,3886,3792,39.0,7109,40,317,1,0,148,7678
48379,10976,5623,5353,45.9,9860,292,64,41,0,591,10976
48381,121090,59037,62053,35.3,109363,2752,675,1816,34,3485,121090
48383,3384,1796,1588,34.4,3007,114,0,0,0,251,3384
48385,3326,1697,1629,51.8,3252,2,0,6,0,27,3326
48387,12795,6117,6678,44.5,10059,2205,154,11,19,159,12795
48389,13606,7527,6079,36.4,11816,548,274,48,0,695,13606
48391,7352,3649,3703,43.7,6423,416,10,49,0,124,7352
48393,992,467,525,41.9,975,0,1,10,0,0,992
48395,16596,8232,8364,40.7,12107,3616,47,109,0,564,16596
48397,78749,38600,40149,35.8,67839,4008,524,1841,404,2265,78749
48399,10473,5201,5272,43.1,9680,214,32,31,0,334,10473
48401,53211,28099,25112,39.3,42018,9488,192,257,6,630,53211
48403,10642,5238,5404,50.2,9630,946,0,0,0,21,10642
48405,8898,4198,4700,47.6,6427,2271,40,38,0,67,8898
48407,26482,13006,13476,43.0,22734,2866,26,171,0,327,26482
48409,65352,32631,32721,35.8,59426,1332,362,600,3,2709,65352
48411,6037,3275,2762,41.7,5391,134,7,15,0,351,6037
48413,3327,1613,1714,36.1,2903,12,37,6,0,323,3327
48415,16855,8948,7907,37.2,13380,754,100,47,0,2256,16855
48417,3346,1621,1725,43.1,3014,46,11,0,0,251,3346
48419,25602,12568,13034,37.9,20022,4580,14,118,0,639,25602
48421,3040,1558,1482,35.4,2601,5,4,6,0,353,3040
48423,209691,101228,108463,35.8,159100,38047,846,2581,348,5735,209691
48425,8444,4147,4297,39.4,7619,107,31,10,0,649,8444
48427,60882,29464,31418,29.0,56702,53,95,45,0,3293,60882
48429,9561,4983,4578,40.5,8176,236,32,49,0,1018,9561
48431,1223,658,565,43.5,1187,2,0,0,0,34,1223
48433,1447,802,645,45.8,1278,46,11,0,0,88,1447
48435,4123,1980,2143,35.3,3793,42,21,0,0,264,4123
48437,7816,4255,3561,36.4,6694,446,19,33,32,335,7816
48439,1814667,890267,924400,33.4,1273774,269911,9312,84660,3198,131728,1814667
48441,131425,63976,67449,32.6,109139,9766,660,2105,111,6287,131425
48443,1001,528,473,47.1,962,0,0,39,0,0,1001
48445,12561,6843,5718,35.5,10278,621,33,10,0,1439,12561
48447,1626,860,766,49.2,1613,2,0,0,0,2,1626
48449,32045,15872,16173,32.8,25679,3254,130,231,0,2026,32045
48451,110434,54325,56109,34.2,95978,4501,648,1172,70,5427,110434
48453,1034842,522384,512458,32.0,746424,87799,5972,60637,820,106507,1034842
48455,14466,6742,7724,46.5,12781,1510,27,59,0,22,14466
48457,21638,11757,9881,42.2,18437,2379,147,87,0,402,21638
48459,39386,19410,19976,40.4,33960,3345,222,197,23,769,39386
48461,3300,1641,1659,37.1,2654,90,9,0,0,486,3300
48463,26434,12880,13554,35.2,24598,259,105,130,20,1078,26434
48465,48578,24390,24188,32.6,44374,677,193,261,0,2589,48578
48467,52507,25865,26642,42.3,49242,1250,441,202,164,395,52507
48469,87188,42616,44572,36.2,71237,5499,339,999,14,5336,87188
48471,67447,40395,27052,35.0,49370,15263,157,718,0,1166,67447
48473,42894,21287,21607,32.3,28956,10348,469,134,0,1673,42894
48475,10705,5270,5435,36.5,9229,583,82,33,0,658,10705
48477,33628,16647,16981,41.1,26363,6005,196,485,0,301,33628
48479,250320,121436,128884,27.8,233062,765,806,1900,20,11889,250320
48481,41153,20200,20953,37.3,33091,5931,91,101,0,1453,41153
48483,5414,2727,2687,40.5,4720,172,44,48,0,367,5414
48485,131019,67334,63685,34.1,106322,13633,1041,2790,102,3709,131019
48487,13451,6801,6650,37.8,11315,1114,76,117,0,531,13451
48489,21983,11820,10163,31.9,20635,418,119,0,0,670,21983
48491,426296,209823,216473,34.4,348720,27063,1363,21268,116,15632,426296
48493,42999,21267,21732,39.8,37824,703,159,205,0,3164,42999
48495,7137,3630,3507,34.4,6393,201,81,27,0,234,7137
48497,59351,29920,29431,38.5,55418,610,533,202,38,1567,59351
48499,41927,20705,21222,47.5,38267,2057,235,205,9,769,41927
48501,7918,3900,4018,31.8,6508,97,53,40,0,1046,7918
48503,18368,9050,9318,42.4,17017,244,89,8,0,467,18368
48505,14014,7043,6971,27.9,13801,25,0,0,0,188,14014
48507,11753,5825,5928,31.1,10308,21,0,0,0,1386,11753
49001,6527,3385,3142,31.5,6345,10,27,0,95,13,6527
49003,49660,24963,24697,30.9,46316,109,319,375,68,1445,49660
49005,112095,55762,56333,25.5,103302,650,748,2165,184,2676,112095
49007,21153,10515,10638,34.6,19369,95,282,158,20,833,21153
49009,897,513,384,48.2,840,0,4,6,4,15,897
49011,306664,154109,152555,29.4,279043,3759,1587,5736,1911,7279,306664
49013,18537,9399,9138,29.8,17023,71,911,88,41,218,18537
49015,10902,5525,5377,33.0,10490,47,49,37,0,170,10902
49017,5107,2642,2465,40.8,4869,17,97,65,24,4,5107
49019,9183,4683,4500,40.0,8561,33,429,47,21,19,9183
49021,45984,23082,22902,26.6,42704,195,1025,287,210,321,45984
49023,10233,5165,5068,29.6,9923,36,82,37,13,36,10233
49025,7093,3480,3613,45.5,6900,10,14,7,8,99,7093
49027,12436,6382,6054,34.0,11646,88,124,18,20,390,12436
49029,9485,4823,4662,31.9,9253,0,0,44,0,86,9485
49031,1699,839,860,42.2,1653,3,1,0,2,27,1699
49033,2264,1158,1106,33.0,2213,3,3,0,2,13,2264
49035,1032226,519200,513026,30.8,887588,16684,7887,34277,16106,43143,1032226
49037,14707,7366,7341,30.2,7084,22,7168,68,64,57,14707
49039,27645,14478,13167,28.9,25471,263,285,135,154,998,27645
49041,20759,10495,10264,32.9,19803,94,262,51,25,292,20759
49043,36598,18761,17837,36.7,34598,108,141,691,8,729,36598
49045,58158,29187,28971,29.5,54914,540,546,436,215,644,58158
49047,32809,16685,16124,29.4,27845,41,2033,186,508,985,32809
49049,516571,258985,257586,24.5,471667,2937,3113,7042,4349,15012,516571
49051,23661,11936,11725,31.9,22709,59,78,193,10,291,23661
49053,139484,68906,70578,32.5,129149,613,1849,988,1135,3574,139484
49055,2756,1404,1352,36.9,2688,23,31,0,0,6,2756
49057,230940,116158,114782,30.9,201311,3402,1728,2944,569,15667,230940
50001,36814,18438,18376,41.8,35217,320,114,554,32,68,36814
50003,36990,17971,19019,45.1,35700,171,42,224,0,70,36990
50005,31170,15453,15717,42.3,30124,230,84,260,21,45,31170
50007,156696,76437,80259,36.4,144836,2878,452,4386,6,649,156696
50009,6316,3172,3144,46.7,6123,34,29,19,0,13,6316
50011,47853,23737,24116,39.6,45603,210,399,239,0,264,47853
50013,7032,3526,3506,45.8,6714,10,44,16,0,11,7032
50015,24471,12251,12220,40.1,23613,133,65,121,0,109,24471
50017,28980,14490,14490,43.5,28116,78,80,168,2,64,28980
50019,27198,13568,13630,43.9,26372,208,100,112,5,42,27198
50021,61599,30443,31156,44.3,59763,291,90,306,0,255,61599
50023,59462,29375,30087,42.5,57276,540,173,522,11,77,59462
50025,44310,21745,22565,44.9,42234,446,60,438,51,105,44310
50027,56607,27823,28784,45.5,54560,255,123,526,2,164,56607
51001,33454,16230,17224,44.5,22586,9620,112,41,0,480,33454
51003,99484,47564,51920,38.2,81403,9751,313,4240,0,1027,99484
51005,16297,7956,8341,46.1,15210,801,6,127,0,10,16297
51007,12674,6272,6402,41.6,9219,3052,117,59,18,16,12674
51009,32301,15406,16895,42.4,24630,6083,331,196,18,304,32301
51011,14952,7374,7578,42.3,11468,3206,12,27,0,16,14952
51013,209077,104287,104790,33.7,149199,17742,824,20085,142,13954,209077
51015,73662,37616,36046,43.3,68529,2990,231,375,84,835,73662
51017,4713,2286,2427,45.4,4499,169,0,34,0,11,4713
51019,68750,33950,34800,44.0,62962,3830,96,721,30,105,68750
51021,6827,3858,2969,44.2,6618,189,0,0,0,0,6827
51023,33074,16213,16861,45.0,31320,1132,2,123,0,55,33074
51025,17372,9118,8254,41.0,7162,9969,0,35,0,46,17372
51027,24071,12227,11844,43.9,23162,478,129,175,0,73,24071
51029,17071,9527,7544,41.4,10562,6167,51,89,0,52,17071
51031,54797,26569,28228,41.4,45296,7938,132,420,8,208,54797
51033,28510,14145,14365,38.6,18964,8435,135,141,0,150,28510
51035,29989,15019,14970,45.0,29225,247,0,43,0,99,29989
51036,7226,3576,3650,47.1,3008,3579,469,10,7,3,7226
51037,12546,6162,6384,43.5,8420,3819,64,17,0,105,12546
51041,316895,152721,164174,37.5,222916,70601,1066,10904,184,4257,316895
51043,14143,7009,7134,44.7,12805,799,49,140,0,131,14143
51045,5186,2488,2698,45.0,5080,10,0,13,0,0,5186
51047,46894,23600,23294,37.9,36090,7027,69,746,66,1322,46894
51049,9951,4959,4992,41.8,6348,3399,11,0,12,0,9951
51051,15877,8019,7858,43.5,15685,68,0,38,0,0,15877
51053,27926,13692,14234,40.8,18006,9280,62,140,0,171,27926
51057,11130,5324,5806,43.8,6526,4300,64,14,24,12,11130
51059,1083770,535616,548154,37.5,691090,99298,4623,190824,934,53010,1083770
51061,65495,32357,33138,41.0,57199,5393,32,896,20,363,65495
51063,15268,7437,7831,44.2,14590,186,165,139,0,0,15268
51065,25749,11633,14116,41.1,20836,4006,74,180,0,61,25749
51067,56012,27673,28339,44.3,50306,4801,62,171,0,45,56012
51069,78397,39093,39304,39.2,71186,3258,62,1057,163,1198,78397
51071,17149,8424,8725,43.0,16585,230,17,32,0,40,17149
51073,36821,18083,18738,41.9,32179,3367,179,332,7,101,36821
51075,21496,10687,10809,45.3,16653,4413,12,106,0,53,21496
51077,15535,7565,7970,47.0,14941,354,0,4,93,51,15535
51079,18453,9222,9231,39.5,16460,1244,0,191,27,182,18453
51081,12127,7710,4417,42.1,4599,7264,24,52,0,73,12127
51083,36140,17266,18874,44.6,21860,13513,51,125,0,422,36140
51085,99964,49050,50914,41.2,86520,9225,274,1307,31,970,99964
51087,307576,144671,162905,37.5,185352,89917,1108,19967,111,4097,307576
51089,53971,25895,28076,44.5,40414,11750,16,274,0,617,53971
51091,2317,1090,1227,56.5,2295,0,0,0,0,5,2317
51093,35240,17201,18039,43.7,25290,8766,55,345,0,228,35240
51095,66939,32396,34543,44.9,54220,9044,208,1861,77,436,66939
51097,6968,3581,3387,44.7,4756,2148,19,12,0,8,6968
51099,23739,11879,11860,36.5,18280,4530,54,246,6,79,23739
51101,15861,7688,8173,39.3,12278,3010,218,23,0,77,15861
51103,11371,5383,5988,54.2,7963,3211,0,109,0,11,11371
51105,25528,13410,12118,41.4,24090,959,95,54,8,135,25528
51107,314980,155549,159431,34.8,220871,23431,630,46369,107,12007,314980
51109,33083,16284,16799,43.1,26038,5970,120,186,0,197,33083
51111,12838,6834,6004,43.8,7911,4553,5,5,12,135,12838
51113,13270,6531,6739,44.7,11311,1524,0,87,13,72,13270
51115,8965,4239,4726,50.3,7818,875,33,30,0,86,8965
51117,32548,15990,16558,45.9,19346,11968,46,237,14,562,32548
51119,10855,5412,5443,51.2,8647,2146,31,0,0,12,10855
51121,94179,49031,45148,26.5,82549,3632,208,5284,26,881,94179
51125,15000,7099,7901,47.7,12407,2381,29,20,0,8,15000
51127,18460,9428,9032,42.0,14999,2952,156,94,0,94,18460
51131,12408,6053,6355,47.3,7483,4750,0,53,0,66,12408
51133,12389,6070,6319,53.5,8788,3592,0,0,0,0,12389
51135,15875,8113,7762,43.0,9188,6312,41,37,0,186,15875
51137,33625,16473,17152,42.7,27909,4399,57,191,0,308,33625
51139,24038,11916,12122,43.0,23091,371,49,122,0,29,24038
51141,18513,9216,9297,46.1,17127,1250,53,2,0,10,18513
51143,63318,31137,32181,44.3,47613,13794,38,166,13,663,63318
51145,28003,15519,12484,42.1,23624,3877,63,155,0,69,28003
51147,23017,11296,11721,33.4,14477,7865,40,165,2,257,23017
51149,36013,19594,16419,37.6,22276,11654,321,623,116,474,36013
51153,404011,200718,203293,33.5,242288,80814,1400,30258,359,29503,404011
51155,34869,17354,17515,44.2,32300,1832,20,178,0,58,34869
51157,7440,3644,3796,48.0,6857,372,33,9,0,37,7440
51159,9234,5250,3984,43.2,6143,2790,71,16,0,80,9234
51161,92432,44069,48363,42.9,83195,5043,162,2452,0,314,92432
51163,22357,11011,11346,46.8,21134,688,33,152,32,5,22357
51165,76353,37322,39031,40.3,72945,1216,313,581,0,557,76353
51167,28773,14197,14576,42.9,27989,403,27,72,0,119,28773
51169,23061,11516,11545,44.7,22701,150,0,53,0,4,23061
51171,42076,20534,21542,42.7,40016,888,40,239,14,344,42076
51173,32103,15713,16390,43.3,31017,641,98,91,0,6,32103
51175,18576,9705,8871,43.9,11223,6925,50,17,0,28,18576
51177,122854,60278,62576,36.4,92339,19432,378,2954,193,5081,122854
51179,129446,65063,64383,34.5,92277,22393,740,3419,168,6150,129446
51181,6988,3462,3526,45.3,3570,3307,4,47,0,27,6988
51183,12095,7171,4924,40.5,4858,7053,10,15,0,68,12095
51185,44846,22154,22692,43.4,42672,1210,68,140,0,121,44846
51187,37567,18615,18952,39.8,34487,1477,121,262,42,182,37567
51191,54691,26827,27864,43.2,53076,692,82,229,0,114,54691
51193,17468,8467,9001,46.5,11957,5198,3,41,0,54,17468
51195,41361,21486,19875,39.5,38463,2155,28,164,0,134,41361
51197,29203,14369,14834,42.9,27849,1099,11,170,0,20,29203
51199,65503,32027,33476,39.6,50812,9061,142,3087,149,266,65503
51510,140337,67565,72772,35.7,89211,30599,552,8462,143,5992,140337
51515,6103,2729,3374,44.7,4638,1314,0,26,0,10,6103
51520,17747,8291,9456,40.8,16112,1062,111,138,0,71,17747
51530,6679,3083,3596,38.0,6074,535,15,4,2,9,6679
51540,43223,20775,22448,28.1,29970,8661,186,2818,27,515,43223
51550,223233,108598,114635,36.7,139846,66739,902,6932,133,3043,223233
51570,17426,8103,9323,41.6,14296,2279,41,554,0,87,17426
51580,5903,2983,2920,43.8,4964,715,15,28,0,37,5903
51590,43185,19737,23448,42.7,20663,20875,18,436,8,565,43185
51595,5825,2718,3107,39.2,1862,3729,13,20,0,143,5825
51600,22712,11146,11566,38.5,16371,1079,137,3578,32,776,22712
51610,12300,5857,6443,36.9,9533,634,8,1212,0,602,12300
51620,8531,3808,4723,40.1,3379,4916,0,72,0,15,8531
51630,24932,11662,13270,28.8,16220,5850,102,624,3,1434,24932
51640,6942,3187,3755,44.7,6482,270,38,10,0,0,6942
51650,137471,66020,71451,35.5,59665,69527,629,3295,67,1265,137471
51660,49043,23142,25901,22.7,41586,3661,54,1912,73,701,49043
51670,22501,10684,11817,35.9,12915,8724,40,57,0,197,22501
51678,6990,4424,2566,21.7,5572,616,0,307,0,214,6990
51680,75657,35319,40338,30.3,49167,21809,140,1890,5,647,75657
51683,37943,18942,19001,32.3,27524,5410,18,1495,0,1851,37943
51685,14409,7082,7327,31.0,8849,1876,93,1098,0,1579,14409
51690,13854,6133,7721,44.1,6803,6137,86,147,0,353,13854
51700,180831,87134,93697,32.3,91768,72991,751,5085,357,2988,180831
51710,243056,125797,117259,29.6,116753,104880,1094,8219,567,4037,243056
51720,3971,1681,2290,39.8,3576,290,0,0,0,55,3971
51730,32226,14985,17241,39.8,5921,25625,47,232,7,79,32226
51735,12110,5910,6200,43.3,11521,51,0,406,0,31,12110
51740,95786,46114,49672,35.3,40037,50735,200,1049,22,888,95786
51750,16511,7769,8742,21.9,14337,1338,0,279,14,182,16511
51760,205348,97537,107811,32.2,88522,102477,679,4551,74,2707,205348
51770,96742,46049,50693,38.4,63434,27018,210,1750,13,1100,96742
51775,24792,11720,13072,39.8,21931,1779,30,388,0,373,24792
51790,23906,10689,13217,42.6,19985,2967,36,153,0,123,23906
51800,84216,40476,43740,38.2,44201,35374,77,1300,7,439,84216
51810,439528,215485,224043,34.8,301851,84398,1200,27541,525,5019,439528
51820,21030,10070,10960,38.2,17230,2450,191,206,0,384,21030
51830,14207,6620,7587,24.1,10696,2065,0,791,0,240,14207
51840,26330,12883,13447,35.6,21499,2884,45,663,29,560,26330
53001,18575,9453,9122,29.2,11632,24,167,123,18,5929,18575
53003,21658,10445,11213,43.3,20330,104,234,108,38,216,21658
53005,175424,87727,87697,35.7,143741,2437,1787,4710,206,17174,175424
53007,72431,35923,36508,39.8,64135,247,886,522,44,4891,72431
53009,71411,35375,36036,49.0,62920,591,3544,1027,53,548,71411
53011,426984,210963,216021,36.8,367814,8448,2652,17232,2691,10210,426984
53013,4001,2053,1948,48.9,3731,9,57,18,0,80,4001
53015,102138,50534,51604,40.1,92396,516,1750,1353,165,1684,102138
53017,38369,19224,19145,36.8,28809,96,413,294,51,7672,38369
53019,7584,3954,3630,47.0,5758,51,1304,34,22,123,7584
53021,78680,40979,37701,28.4,46005,1528,604,1539,30,26643,78680
53023,2246,1092,1154,52.6,2130,0,0,28,0,0,2246
53025,88885,45306,43579,32.1,61729,960,1009,959,31,21486,88885
53027,72272,37153,35119,42.0,62497,858,2936,991,174,2049,72272
53029,78707,39084,39623,43.6,67571,1461,529,3433,485,1223,78707
53031,29802,14829,14973,53.8,27009,285,526,443,12,145,29802
53033,1940777,967800,972977,37.1,1356608,118815,14772,282493,14554,55583,1940777
53035,251400,127621,123779,39.3,207191,6796,3774,11886,2232,4135,251400
53037,40954,20579,20375,32.4,36731,311,340,1074,2,1563,40954
53039,20421,10258,10163,45.3,18727,107,566,136,52,460,20421
53041,75399,37815,37584,42.0,69299,459,615,601,11,1478,75399
53043,10536,5298,5238,47.8,9912,30,181,41,3,92,10536
53045,60545,31231,29314,44.5,52221,797,2016,902,43,1672,60545
53047,40959,20719,20240,42.2,31011,193,4181,309,194,3511,40959
53049,20945,10545,10400,50.7,18375,99,332,417,13,865,20945
53051,12976,6638,6338,47.6,11791,16,480,28,0,113,12976
53053,798528,395397,403131,35.7,605139,54474,9098,47281,10469,19719,798528
53055,15740,7659,8081,52.9,14779,109,123,247,18,209,15740
53057,117087,58068,59019,40.2,102449,704,1942,2108,234,5248,117087
53059,11053,5568,5485,44.5,10245,11,244,115,41,218,11053
53061,714443,357586,356857,37.2,572692,16600,8685,64209,2807,16691,714443
53063,470375,232547,237828,36.8,420391,8515,6159,10829,1697,5346,470375
53065,43498,21795,21703,45.1,39119,180,2013,270,66,165,43498
53067,252410,123128,129282,38.3,210962,6824,3469,14185,1925,3672,252410
53069,4003,1986,2017,48.8,3790,7,36,32,0,0,4003
53071,58643,29913,28730,37.0,51104,998,610,765,177,3493,58643
53073,201404,99751,101653,36.5,175087,1800,5400,7523,394,3733,201404
53075,44997,22743,22254,24.1,38349,907,241,3385,149,264,44997
53077,242454,121307,121147,32.4,180685,1888,9741,2397,145,39267,242454
54001,16472,8126,8346,41.4,15952,68,114,45,0,0,16472
54003,104410,51539,52871,37.6,92146,7511,183,897,10,888,104410
54005,24617,12234,12383,41.2,24256,232,0,3,0,0,24617
54007,14531,7310,7221,43.4,14294,86,63,11,0,2,14531
54009,24021,11762,12259,44.9,23274,412,51,103,0,45,24021
54011,96240,46890,49350,39.0,88132,4510,217,985,22,109,96240
54013,7613,3812,3801,45.4,7443,18,5,3,0,0,7613
54015,9432,4741,4691,41.9,9284,17,4,0,0,3,9432
54017,8147,4376,3771,41.9,8008,45,1,0,0,0,8147
54019,46000,22954,23046,42.3,42903,2257,103,76,0,163,46000
54021,8623,5112,3511,38.8,7112,994,38,30,0,126,8623
54023,11929,5888,6041,44.0,11652,69,2,0,0,43,11929
54025,35572,17372,18200,44.8,33618,1015,65,94,16,44,35572
54027,23791,12086,11705,42.7,23137,254,0,85,2,87,23791
54029,30594,14772,15822,45.1,29317,579,53,87,0,0,30594
54031,13912,6822,7090,42.1,13237,446,24,13,0,148,13912
54033,68959,33491,35468,41.7,66193,1047,139,348,118,142,68959
54035,29206,14391,14815,41.5,28721,163,5,0,0,0,29206
54037,53545,26593,26952,39.2,47187,3342,45,745,0,627,53545
54039,192572,92447,100125,42.3,171522,8050,243,2082,0,111,192572
54041,16389,8137,8252,44.0,16005,44,14,41,23,0,16389
54043,21714,10739,10975,41.3,21424,51,10,32,0,0,21714
54045,36508,18014,18494,42.2,35274,823,62,118,1,29,36508
54047,21966,10779,11187,44.0,19511,2288,14,26,0,0,21966
54049,56460,27496,28964,41.3,53352,1928,35,142,29,34,56460
54051,32993,16094,16899,44.0,32362,209,29,153,0,31,32993
54053,27242,13184,14058,42.2,26601,174,15,0,0,0,27242
54055,62251,29704,32547,42.1,57036,3566,223,370,0,165,62251
54057,28049,13805,14244,42.1,26754,935,4,14,0,25,28049
54059,26660,13076,13584,41.7,25762,593,14,79,0,39,26660
54061,96417,49749,46668,29.3,87808,3234,121,3163,45,306,96417
54063,13528,6714,6814,44.9,13181,117,49,0,0,0,13528
54065,17507,8708,8799,44.9,17073,131,11,87,0,0,17507
54067,26201,12795,13406,43.9,25668,3,186,131,0,27,26201
54069,44307,21032,23275,43.2,41418,1664,70,432,1,59,44307
54071,7666,3933,3733,47.6,7327,229,6,7,0,33,7666
54073,7630,4107,3523,42.1,7383,69,12,0,0,0,7630
54075,8750,4454,4296,47.5,8509,119,3,12,0,1,8750
54077,33471,17211,16260,41.7,31899,1067,57,36,0,87,33471
54079,55660,27149,28511,41.2,54017,655,30,433,14,19,55660
54081,78852,39417,39435,40.7,69897,6663,176,905,23,292,78852
54083,29361,15139,14222,43.6,28567,318,37,122,51,14,29361
54085,10391,5167,5224,44.4,10240,27,27,5,0,12,10391
54087,14884,7347,7537,43.3,14001,1,34,8,0,2,14884
54089,13813,6191,7622,46.2,13184,458,0,43,28,17,13813
54091,16889,8496,8393,42.4,16441,176,38,10,25,11,16889
54093,7109,3543,3566,46.2,6999,24,0,5,0,0,7109
54095,9188,4540,4648,45.1,9094,24,15,2,0,0,9188
54097,24210,12001,12209,41.3,23619,185,15,83,0,35,24210
54099,42273,20544,21729,41.7,41662,69,57,105,0,17,42273
54101,9158,4525,4633,44.7,9061,4,0,15,0,0,9158
54103,16526,8065,8461,44.9,16320,48,7,61,19,0,16526
54105,5769,2970,2799,43.9,5585,20,22,0,0,31,5769
54107,86835,41805,45030,41.8,83725,985,135,442,62,169,86835
54109,23668,11794,11874,42.4,23222,244,51,5,42,0,23668
55001,20898,11313,9585,48.9,19488,665,124,87,21,190,20898
55003,16113,8054,8059,41.0,13632,59,1637,96,16,60,16113
55005,45882,22912,22970,42.7,44073,488,375,186,4,212,45882
55007,15078,7738,7340,49.3,13106,70,1574,65,0,14,15078
55009,248526,123094,125432,36.2,221071,5176,6127,6858,46,3202,248526
55011,13544,6885,6659,44.0,13195,36,71,11,0,142,13544
55013,15528,7935,7593,49.3,14271,93,775,60,0,48,15528
55015,48960,24724,24236,38.2,46796,96,192,979,0,175,48960
55017,62362,32217,30145,40.2,59571,904,250,797,3,93,62362
55019,34610,17541,17069,37.1,33724,105,189,125,0,205,34610
55021,56596,28797,27799,41.3,54307,750,277,206,20,379,56596
55023,16677,8651,8026,44.5,16117,336,48,56,0,39,16677
55025,490379,242670,247709,34.4,421323,24798,1156,23323,75,6257,490379
55027,88741,46642,42099,40.6,83809,2453,300,488,0,579,88741
55029,27872,13765,14107,49.6,26827,140,135,130,52,347,27872
55031,43963,21915,22048,40.0,40981,596,812,440,16,71,43963
55033,43788,21996,21792,33.6,41585,222,233,1021,0,67,43788
55035,98952,48631,50321,33.2,92174,922,402,3281,14,444,98952
55037,4486,2288,2198,48.5,4239,0,111,6,0,9,4486
55039,101577,49890,51687,40.3,95928,1068,415,999,27,1398,101577
55041,9361,4781,4580,44.0,7719,79,1246,13,7,33,9361
55043,51055,26511,24544,36.5,49661,589,81,259,7,60,51055
55045,36800,18261,18539,41.3,35912,202,77,156,0,126,36800
55047,19064,9493,9571,44.4,18532,93,39,38,8,178,19064
55049,23712,11819,11893,41.4,23236,73,19,133,0,33,23712
55051,5978,3039,2939,51.0,5848,27,33,0,0,1,5978
55053,20436,10914,9522,41.6,18249,532,1067,97,0,91,20436
55055,83751,41664,42087,38.1,79958,610,93,597,0,1249,83751
55057,26701,13974,12727,43.2,25249,407,395,140,11,132,26701
55059,166373,82304,84069,36.5,143577,11440,633,2489,89,4529,166373
55061,20600,10512,10088,41.8,19998,91,159,28,7,144,20600
55063,114718,56065,58653,35.3,105570,1912,468,4785,6,406,114718
55065,16836,8621,8215,41.0,16547,80,56,16,0,44,16836
55067,19951,10103,9848,46.1,19126,102,111,84,25,275,19951
55069,28710,14378,14332,44.8,27862,252,44,176,0,149,28710
55071,81266,40260,41006,43.3,76812,408,513,1919,0,649,81266
55073,134041,67294,66747,39.2,123161,693,417,7226,15,518,134041
55075,41704,20714,20990,45.8,40481,117,186,171,9,174,41704
55077,15366,7806,7560,47.2,14929,47,60,55,0,107,15366
55078,4274,2125,2149,32.6,595,35,3289,146,0,70,4274
55079,946584,457022,489562,33.7,594961,250473,5512,32264,362,34312,946584
55081,44714,22701,22013,38.7,42342,504,522,270,0,448,44714
55083,37632,19155,18477,43.8,36406,69,465,144,0,208,37632
55085,36029,18152,17877,48.2,34890,172,487,180,24,22,36029
55087,176777,88099,88678,37.3,162811,1882,2688,5393,32,1223,176777
55089,86429,42279,44150,43.0,82127,1181,261,1521,0,302,86429
55091,7458,3767,3691,43.8,7337,34,9,23,0,21,7458
55093,40842,20265,20577,34.6,39516,234,187,395,16,56,40842
55095,44094,22073,22021,42.8,42729,146,488,208,0,209,44094
55097,70027,34833,35194,35.8,66145,214,290,2051,3,458,70027
55099,14141,7176,6965,48.8,13729,37,70,76,6,14,14141
55101,195024,96509,98515,39.0,158827,20736,682,2413,62,7199,195024
55103,18020,9003,9017,42.9,17502,86,71,59,2,139,18020
55105,160356,78749,81607,38.3,144904,6268,455,1652,49,2115,160356
55107,14670,7311,7359,46.1,14296,91,60,54,6,41,14670
55109,84363,42252,42111,36.8,80991,660,481,774,9,279,84363
55111,61953,30942,31011,39.9,58210,324,881,358,0,1450,61953
55113,16580,8377,8203,47.2,13131,39,2793,108,6,63,16580
55115,41820,20901,20919,43.2,37337,163,3147,185,36,231,41820
55117,115377,57982,57395,40.2,104972,1675,556,5378,27,973,115377
55119,20631,10550,10081,41.8,20252,65,64,25,0,45,20631
55121,28853,14614,14239,40.9,27434,76,47,99,0,945,28853
55123,29827,14900,14927,41.6,29078,96,40,94,41,196,29827
55125,21489,10898,10591,50.9,18789,184,1831,84,0,23,21489
55127,102310,51161,51149,37.9,95486,982,209,737,35,3304,102310
55129,15893,7877,8016,47.6,15347,53,227,90,1,33,15893
55131,131840,65291,66549,40.9,126726,1321,141,1477,6,689,131840
55133,389740,191242,198498,42.2,365185,4949,537,10093,61,2593,389740
55135,52377,26490,25887,43.4,51003,278,265,248,7,164,52377
55137,24565,12923,11642,46.3,23301,459,118,123,0,324,24565
55139,166984,83799,83185,37.8,155527,2894,958,3777,33,1182,166984
55141,74591,36682,37909,42.5,71322,359,558,1455,0,286,74591
56001,36186,18894,17292,26.8,32215,372,241,1056,29,1188,36186
56003,11636,5845,5791,41.8,11004,2,264,39,2,127,11636
56005,45840,23903,21937,31.8,42317,250,665,308,39,1636,45840
56007,15781,8563,7218,39.4,14335,124,103,176,16,574,15781
56009,13779,7009,6770,40.0,13103,43,147,57,12,248,13779
56011,7036,3603,3433,44.2,6967,4,28,6,0,10,7036
56013,40103,19989,20114,38.3,29748,162,8461,259,8,452,40103
56015,13277,6839,6438,42.8,12579,41,89,26,4,320,13277
56017,4791,2342,2449,49.0,4684,11,36,20,1,4,4791
56019,8564,4384,4180,44.9,8219,1,3,63,0,118,8564
56021,91719,45756,45963,37.3,80263,2530,1027,882,23,3956,91719
56023,17960,9246,8714,37.5,17412,13,86,65,13,85,17960
56025,75876,38314,37562,36.7,70831,639,745,579,0,804,75876
56027,2478,1115,1363,44.5,2337,21,12,9,0,4,2478
56029,28203,14071,14132,43.7,27245,87,258,111,13,80,28203
56031,8677,4394,4283,47.8,8320,1,31,4,0,193,8677
56033,29097,14296,14801,42.5,27257,100,345,222,33,614,29097
56035,10065,5491,4574,38.2,9036,1,53,79,4,8,10065
56037,43890,22901,20989,32.9,40233,194,118,232,7,976,43890
56039,21326,11120,10206,36.6,20483,40,85,116,0,231,21326
56041,20942,10567,10375,34.3,19814,18,46,9,0,125,20942
56043,8425,4248,4177,41.6,7892,31,66,24,0,210,8425
56045,7152,3754,3398,41.7,6727,4,42,50,2,136,7152
